,날짜,구,생활인구수,유동인구수,전체점포수,프랜차이즈점포수,일반점포수,확진자수
0,2020-02-01,강남구,759286.0842,526535,55875,4371,51504,0
1,2020-02-01,강동구,519147.6209,347490.4167,20974,1901,19073,0
2,2020-02-01,강북구,319527.8081,248604.1667,13417,1075,12342,0
3,2020-02-01,강서구,555865.808,452703.3333,25902,2633,23269,0
4,2020-02-01,관악구,520445.2208,415262.5,19734,1908,17826,0
5,2020-02-01,광진구,383472.6917,295070.8333,19004,1662,17342,0
6,2020-02-01,구로구,392477.2573,352515,22318,1785,20533,0
7,2020-02-01,금천구,209278.9225,206976.6667,15677,1274,14403,0
8,2020-02-01,노원구,554617.573,415351.6667,18188,1859,16329,0
9,2020-02-01,도봉구,292981.7444,251284.5833,11691,992,10699,0
10,2020-02-01,동대문구,363740.0053,291802.5,21212,1475,19737,0
11,2020-02-01,동작구,418387.4768,324842.9167,15894,1581,14313,0
12,2020-02-01,마포구,466444.1162,333913.75,28419,2417,26002,0
13,2020-02-01,서대문구,361377.4145,256087.5,15024,1489,13535,0
14,2020-02-01,서초구,551434.4668,379510.8333,36555,2544,34011,0
15,2020-02-01,성동구,344289.7614,246416.6667,17072,1334,15738,0
16,2020-02-01,성북구,440964.3058,344237.5,17228,1584,15644,0
17,2020-02-01,송파구,772424.3241,521996.6667,37450,3186,34264,0
18,2020-02-01,양천구,422719.0307,343681.25,18361,1655,16706,0
19,2020-02-01,영등포구,435040.4807,362681.25,27266,2258,25008,0
20,2020-02-01,용산구,288810.4674,209539.5833,19047,1178,17869,0
21,2020-02-01,은평구,473525.4418,355105,18313,1554,16759,0
22,2020-02-01,종로구,258768.0006,188023.3333,25500,1616,23884,0
23,2020-02-01,중구,214437.6717,165085.4167,40338,2095,38243,0
24,2020-02-01,중랑구,378367.9483,308870,16161,1275,14886,0
25,2020-02-02,강남구,708857.998,481155.8333,55875,4371,51504,0
26,2020-02-02,강동구,527652.6729,348285.4167,20974,1901,19073,0
27,2020-02-02,강북구,327036.8204,253012.0833,13417,1075,12342,0
28,2020-02-02,강서구,559455.7117,451303.75,25902,2633,23269,0
29,2020-02-02,관악구,529535.3086,422640.4167,19734,1908,17826,0
30,2020-02-02,광진구,383759.1783,297366.6667,19004,1662,17342,0
31,2020-02-02,구로구,398702.5587,357306.6667,22318,1785,20533,0
32,2020-02-02,금천구,208384.7363,204742.9167,15677,1274,14403,0
33,2020-02-02,노원구,563385.3289,421574.1667,18188,1859,16329,0
34,2020-02-02,도봉구,301176.4034,259012.0833,11691,992,10699,0
35,2020-02-02,동대문구,366119.2584,293923.75,21212,1475,19737,0
36,2020-02-02,동작구,418515.3484,322735.4167,15894,1581,14313,0
37,2020-02-02,마포구,451895.1685,322555.4167,28419,2417,26002,0
38,2020-02-02,서대문구,358911.8598,255278.3333,15024,1489,13535,0
39,2020-02-02,서초구,526411.8952,356830.4167,36555,2544,34011,0
40,2020-02-02,성동구,338989.23,241337.0833,17072,1334,15738,0
41,2020-02-02,성북구,448735.286,351409.5833,17228,1584,15644,0
42,2020-02-02,송파구,766701.2839,513612.9167,37450,3186,34264,0
43,2020-02-02,양천구,427100.2456,345993.3333,18361,1655,16706,0
44,2020-02-02,영등포구,431477.5257,356991.6667,27266,2258,25008,0
45,2020-02-02,용산구,285030.3037,204483.75,19047,1178,17869,0
46,2020-02-02,은평구,482164.6791,360792.9167,18313,1554,16759,0
47,2020-02-02,종로구,236457.6143,167975.8333,25500,1616,23884,1
48,2020-02-02,중구,189667.5166,142336.6667,40338,2095,38243,0
49,2020-02-02,중랑구,386519.8821,314657.0833,16161,1275,14886,0
50,2020-02-03,강남구,893889.3074,652937.9167,55875,4371,51504,0
51,2020-02-03,강동구,506159.0354,326651.6667,20974,1901,19073,0
52,2020-02-03,강북구,306655.0705,231456.25,13417,1075,12342,0
53,2020-02-03,강서구,550179.4324,438974.1667,25902,2633,23269,0
54,2020-02-03,관악구,491802.845,383356.6667,19734,1908,17826,0
55,2020-02-03,광진구,370903.312,279116.6667,19004,1662,17342,0
56,2020-02-03,구로구,403547.1893,359424.1667,22318,1785,20533,0
57,2020-02-03,금천구,239873.9638,242219.1667,15677,1274,14403,0
58,2020-02-03,노원구,537500.9608,385997.0833,18188,1859,16329,0
59,2020-02-03,도봉구,282619.8757,233058.3333,11691,992,10699,0
60,2020-02-03,동대문구,364669.1226,289180.8333,21212,1475,19737,0
61,2020-02-03,동작구,407553.6555,309692.0833,15894,1581,14313,0
62,2020-02-03,마포구,472153.322,343697.0833,28419,2417,26002,0
63,2020-02-03,서대문구,378892.3453,255959.5833,15024,1489,13535,0
64,2020-02-03,서초구,614356.585,439314.1667,36555,2544,34011,0
65,2020-02-03,성동구,360464.1404,263393.75,17072,1334,15738,0
66,2020-02-03,성북구,429423.2659,329815,17228,1584,15644,0
67,2020-02-03,송파구,776723.3589,520803.75,37450,3186,34264,0
68,2020-02-03,양천구,408789.4281,318955,18361,1655,16706,0
69,2020-02-03,영등포구,489583.9853,418616.6667,27266,2258,25008,0
70,2020-02-03,용산구,297705.1049,217907.0833,19047,1178,17869,0
71,2020-02-03,은평구,451180.5124,324772.0833,18313,1554,16759,0
72,2020-02-03,종로구,302627.0093,240800.4167,25500,1616,23884,0
73,2020-02-03,중구,300909.0735,272013.75,40338,2095,38243,0
74,2020-02-03,중랑구,362468.9207,287881.25,16161,1275,14886,0
75,2020-02-04,강남구,905137.8028,658253.75,55875,4371,51504,0
76,2020-02-04,강동구,504386.5569,325917.9167,20974,1901,19073,0
77,2020-02-04,강북구,305755.7987,230517.0833,13417,1075,12342,0
78,2020-02-04,강서구,549032.4844,438459.5833,25902,2633,23269,0
79,2020-02-04,관악구,490820.0001,382341.6667,19734,1908,17826,0
80,2020-02-04,광진구,370128.6741,278815.4167,19004,1662,17342,0
81,2020-02-04,구로구,402005.0851,357585.8333,22318,1785,20533,0
82,2020-02-04,금천구,239618.2078,241067.9167,15677,1274,14403,0
83,2020-02-04,노원구,533636.4393,383868.3333,18188,1859,16329,0
84,2020-02-04,도봉구,280657.8497,231421.25,11691,992,10699,0
85,2020-02-04,동대문구,363631.5551,288920,21212,1475,19737,0
86,2020-02-04,동작구,408304.7224,309656.6667,15894,1581,14313,0
87,2020-02-04,마포구,474571.7205,344912.9167,28419,2417,26002,0
88,2020-02-04,서대문구,380307.5082,256328.75,15024,1489,13535,0
89,2020-02-04,서초구,618718.1357,441645.8333,36555,2544,34011,0
90,2020-02-04,성동구,361202.3976,263338.3333,17072,1334,15738,0
91,2020-02-04,성북구,429500.4586,330232.9167,17228,1584,15644,0
92,2020-02-04,송파구,776252.3989,520174.1667,37450,3186,34264,0
93,2020-02-04,양천구,407623.8489,317742.9167,18361,1655,16706,0
94,2020-02-04,영등포구,490319.1001,417994.5833,27266,2258,25008,0
95,2020-02-04,용산구,298682.2055,219155,19047,1178,17869,0
96,2020-02-04,은평구,448845.7093,323807.9167,18313,1554,16759,0
97,2020-02-04,종로구,307809.9472,244687.9167,25500,1616,23884,0
98,2020-02-04,중구,304395.4864,273523.3333,40338,2095,38243,0
99,2020-02-04,중랑구,360026.6511,286394.5833,16161,1275,14886,0
100,2020-02-05,강남구,904396.2567,657332.5,55875,4371,51504,0
101,2020-02-05,강동구,505542.862,326007.9167,20974,1901,19073,0
102,2020-02-05,강북구,306940.3933,231005.4167,13417,1075,12342,0
103,2020-02-05,강서구,550907.9825,438465,25902,2633,23269,0
104,2020-02-05,관악구,491753.0808,383261.25,19734,1908,17826,0
105,2020-02-05,광진구,368516.2062,278718.3333,19004,1662,17342,0
106,2020-02-05,구로구,402940.1108,357325.4167,22318,1785,20533,0
107,2020-02-05,금천구,238888.9208,239910,15677,1274,14403,0
108,2020-02-05,노원구,533667.9371,384615.4167,18188,1859,16329,0
109,2020-02-05,도봉구,280832.1224,232027.9167,11691,992,10699,0
110,2020-02-05,동대문구,364712.4231,288829.1667,21212,1475,19737,0
111,2020-02-05,동작구,408439.7929,309727.9167,15894,1581,14313,0
112,2020-02-05,마포구,474884.5245,344854.5833,28419,2417,26002,0
113,2020-02-05,서대문구,380963.6736,256471.25,15024,1489,13535,0
114,2020-02-05,서초구,618152.7053,440965,36555,2544,34011,0
115,2020-02-05,성동구,360743.6027,263325.8333,17072,1334,15738,0
116,2020-02-05,성북구,428485.9381,330221.6667,17228,1584,15644,1
117,2020-02-05,송파구,777111.7918,520737.9167,37450,3186,34264,1
118,2020-02-05,양천구,407147.3635,317605.4167,18361,1655,16706,0
119,2020-02-05,영등포구,489778.3211,417897.9167,27266,2258,25008,0
120,2020-02-05,용산구,298942.9296,219057.0833,19047,1178,17869,0
121,2020-02-05,은평구,449972.1032,324179.5833,18313,1554,16759,0
122,2020-02-05,종로구,307590.9415,242954.5833,25500,1616,23884,0
123,2020-02-05,중구,302276.2812,271464.1667,40338,2095,38243,0
124,2020-02-05,중랑구,360441.8052,287110.8333,16161,1275,14886,0
125,2020-02-06,강남구,902459.8279,652207.5,55875,4371,51504,0
126,2020-02-06,강동구,506050.438,327072.5,20974,1901,19073,0
127,2020-02-06,강북구,305741.4458,230462.5,13417,1075,12342,0
128,2020-02-06,강서구,549934.55,438588.3333,25902,2633,23269,0
129,2020-02-06,관악구,490158.0537,385070.4167,19734,1908,17826,0
130,2020-02-06,광진구,367764.3233,279660,19004,1662,17342,0
131,2020-02-06,구로구,402728.9219,356687.9167,22318,1785,20533,0
132,2020-02-06,금천구,238373.9296,238434.1667,15677,1274,14403,0
133,2020-02-06,노원구,532903.8554,389114.5833,18188,1859,16329,0
134,2020-02-06,도봉구,280411.2665,219889.5833,11691,992,10699,0
135,2020-02-06,동대문구,363550.0728,288331.6667,21212,1475,19737,0
136,2020-02-06,동작구,407236.7823,310045,15894,1581,14313,0
137,2020-02-06,마포구,475897.5837,345798.3333,28419,2417,26002,0
138,2020-02-06,서대문구,379890.3262,256048.75,15024,1489,13535,1
139,2020-02-06,서초구,618351.9562,439798.75,36555,2544,34011,0
140,2020-02-06,성동구,359170.3378,262892.9167,17072,1334,15738,0
141,2020-02-06,성북구,426898.529,330529.5833,17228,1584,15644,0
142,2020-02-06,송파구,776355.3173,520893.75,37450,3186,34264,0
143,2020-02-06,양천구,406534.0368,318041.6667,18361,1655,16706,0
144,2020-02-06,영등포구,487576.9152,416530.4167,27266,2258,25008,0
145,2020-02-06,용산구,299612.3686,219971.25,19047,1178,17869,0
146,2020-02-06,은평구,448968.2739,324882.0833,18313,1554,16759,0
147,2020-02-06,종로구,306531.6725,240435.8333,25500,1616,23884,0
148,2020-02-06,중구,301406.5743,267320,40338,2095,38243,0
149,2020-02-06,중랑구,360769.7359,287799.5833,16161,1275,14886,0
150,2020-02-07,강남구,899826.2142,654097.9167,55875,4371,51504,0
151,2020-02-07,강동구,506553.8983,327106.25,20974,1901,19073,0
152,2020-02-07,강북구,306378.7089,231237.9167,13417,1075,12342,0
153,2020-02-07,강서구,549633.5362,438200.8333,25902,2633,23269,0
154,2020-02-07,관악구,489650.0962,383875.4167,19734,1908,17826,0
155,2020-02-07,광진구,368957.7104,279888.3333,19004,1662,17342,0
156,2020-02-07,구로구,401603.9482,355072.0833,22318,1785,20533,0
157,2020-02-07,금천구,237275.7168,237334.1667,15677,1274,14403,0
158,2020-02-07,노원구,532063.6634,390445.8333,18188,1859,16329,0
159,2020-02-07,도봉구,280519.1462,217462.9167,11691,992,10699,0
160,2020-02-07,동대문구,363213.2695,287788.3333,21212,1475,19737,0
161,2020-02-07,동작구,406359.9421,309072.0833,15894,1581,14313,0
162,2020-02-07,마포구,477533.4607,348050,28419,2417,26002,0
163,2020-02-07,서대문구,375805.7402,254752.9167,15024,1489,13535,0
164,2020-02-07,서초구,619705.1305,441938.3333,36555,2544,34011,0
165,2020-02-07,성동구,358220.009,262712.5,17072,1334,15738,0
166,2020-02-07,성북구,424304.0847,328675,17228,1584,15644,0
167,2020-02-07,송파구,773675.0301,520505,37450,3186,34264,0
168,2020-02-07,양천구,407099.2081,318602.5,18361,1655,16706,0
169,2020-02-07,영등포구,487028.6134,417445,27266,2258,25008,0
170,2020-02-07,용산구,301576.5216,221033.3333,19047,1178,17869,0
171,2020-02-07,은평구,447640.3945,322782.5,18313,1554,16759,0
172,2020-02-07,종로구,306859.7228,242096.6667,25500,1616,23884,1
173,2020-02-07,중구,299202.7701,266370.4167,40338,2095,38243,0
174,2020-02-07,중랑구,360292.0231,286795,16161,1275,14886,0
175,2020-02-08,강남구,762835.8466,507350.4167,55875,4371,51504,0
176,2020-02-08,강동구,521342.2665,344411.25,20974,1901,19073,0
177,2020-02-08,강북구,321574.316,251888.75,13417,1075,12342,0
178,2020-02-08,강서구,557191.1915,448300,25902,2633,23269,0
179,2020-02-08,관악구,520451.8895,419245,19734,1908,17826,0
180,2020-02-08,광진구,383692.293,298932.5,19004,1662,17342,0
181,2020-02-08,구로구,393779.3968,352589.5833,22318,1785,20533,0
182,2020-02-08,금천구,210726.9,204012.5,15677,1274,14403,0
183,2020-02-08,노원구,557804.9343,424574.1667,18188,1859,16329,0
184,2020-02-08,도봉구,294381.3184,237100.8333,11691,992,10699,0
185,2020-02-08,동대문구,366327.423,289282.0833,21212,1475,19737,0
186,2020-02-08,동작구,419001.4139,322171.6667,15894,1581,14313,0
187,2020-02-08,마포구,463265.1935,340152.0833,28419,2417,26002,0
188,2020-02-08,서대문구,359867.7129,253515.8333,15024,1489,13535,0
189,2020-02-08,서초구,551130.7629,363724.1667,36555,2544,34011,0
190,2020-02-08,성동구,344303.1042,242616.25,17072,1334,15738,0
191,2020-02-08,성북구,439517.4556,344394.1667,17228,1584,15644,0
192,2020-02-08,송파구,768456.8358,513007.5,37450,3186,34264,0
193,2020-02-08,양천구,424916.841,339783.75,18361,1655,16706,0
194,2020-02-08,영등포구,434068.5163,357430.8333,27266,2258,25008,0
195,2020-02-08,용산구,287592.6812,205392.0833,19047,1178,17869,0
196,2020-02-08,은평구,475639.1454,356401.6667,18313,1554,16759,0
197,2020-02-08,종로구,254424.6902,173182.5,25500,1616,23884,0
198,2020-02-08,중구,205896.9866,148728.3333,40338,2095,38243,0
199,2020-02-08,중랑구,379176.1843,310301.25,16161,1275,14886,0
200,2020-02-09,강남구,710114.2114,477099.5833,55875,4371,51504,0
201,2020-02-09,강동구,528784.3883,347192.5,20974,1901,19073,0
202,2020-02-09,강북구,329044.6272,252743.75,13417,1075,12342,0
203,2020-02-09,강서구,560312.4509,449940.4167,25902,2633,23269,0
204,2020-02-09,관악구,529948.511,420785,19734,1908,17826,0
205,2020-02-09,광진구,384711.6624,296137.0833,19004,1662,17342,0
206,2020-02-09,구로구,399167.7462,353052.0833,22318,1785,20533,0
207,2020-02-09,금천구,209203.9293,204162.0833,15677,1274,14403,0
208,2020-02-09,노원구,563835.2211,427909.5833,18188,1859,16329,0
209,2020-02-09,도봉구,301836.1746,242190,11691,992,10699,0
210,2020-02-09,동대문구,366351.2999,291456.6667,21212,1475,19737,0
211,2020-02-09,동작구,418056.6178,320468.3333,15894,1581,14313,0
212,2020-02-09,마포구,450578.6042,322700.4167,28419,2417,26002,0
213,2020-02-09,서대문구,358622.285,253751.6667,15024,1489,13535,0
214,2020-02-09,서초구,524873.2592,353381.25,36555,2544,34011,0
215,2020-02-09,성동구,338534.7325,239817.9167,17072,1334,15738,0
216,2020-02-09,성북구,446211.125,349203.75,17228,1584,15644,0
217,2020-02-09,송파구,762660.6532,509733.3333,37450,3186,34264,0
218,2020-02-09,양천구,427779.584,344936.25,18361,1655,16706,0
219,2020-02-09,영등포구,428712.3355,354362.9167,27266,2258,25008,0
220,2020-02-09,용산구,285174.6131,202930,19047,1178,17869,0
221,2020-02-09,은평구,482239.5663,360287.9167,18313,1554,16759,0
222,2020-02-09,종로구,235425.8245,165761.6667,25500,1616,23884,0
223,2020-02-09,중구,185631.2042,137359.5833,40338,2095,38243,0
224,2020-02-09,중랑구,385414.3964,313225.8333,16161,1275,14886,0
225,2020-02-10,강남구,892477.8526,647752.9167,55875,4371,51504,0
226,2020-02-10,강동구,505888.7191,325811.25,20974,1901,19073,0
227,2020-02-10,강북구,307063.1595,230501.6667,13417,1075,12342,0
228,2020-02-10,강서구,551603.7273,438327.0833,25902,2633,23269,0
229,2020-02-10,관악구,491716.0554,383811.25,19734,1908,17826,0
230,2020-02-10,광진구,370593.2984,278950.4167,19004,1662,17342,0
231,2020-02-10,구로구,402765.4856,356352.5,22318,1785,20533,0
232,2020-02-10,금천구,240545.3271,241787.5,15677,1274,14403,0
233,2020-02-10,노원구,533461.1204,385832.9167,18188,1859,16329,0
234,2020-02-10,도봉구,281915.3183,228748.75,11691,992,10699,0
235,2020-02-10,동대문구,364819.5028,287630.8333,21212,1475,19737,0
236,2020-02-10,동작구,408502.228,308728.3333,15894,1581,14313,0
237,2020-02-10,마포구,473357.5053,344684.1667,28419,2417,26002,0
238,2020-02-10,서대문구,376451.1345,253704.1667,15024,1489,13535,0
239,2020-02-10,서초구,612069.4583,436382.9167,36555,2544,34011,0
240,2020-02-10,성동구,358343.3508,261884.5833,17072,1334,15738,0
241,2020-02-10,성북구,428566.7625,330655,17228,1584,15644,0
242,2020-02-10,송파구,770786.906,518221.6667,37450,3186,34264,0
243,2020-02-10,양천구,406910.9585,317550.8333,18361,1655,16706,0
244,2020-02-10,영등포구,486792.2103,417164.1667,27266,2258,25008,0
245,2020-02-10,용산구,296388.6247,217346.6667,19047,1178,17869,0
246,2020-02-10,은평구,450971.7671,324344.5833,18313,1554,16759,0
247,2020-02-10,종로구,303967.8971,241393.3333,25500,1616,23884,0
248,2020-02-10,중구,298142.9784,268246.25,40338,2095,38243,0
249,2020-02-10,중랑구,361658.2077,287578.3333,16161,1275,14886,0
250,2020-02-11,강남구,907750.1357,656480.4167,55875,4371,51504,0
251,2020-02-11,강동구,504294.04,325009.1667,20974,1901,19073,0
252,2020-02-11,강북구,305995.9931,229142.9167,13417,1075,12342,0
253,2020-02-11,강서구,550177.9786,436071.25,25902,2633,23269,0
254,2020-02-11,관악구,491099.3048,382494.1667,19734,1908,17826,0
255,2020-02-11,광진구,368343.0591,277960,19004,1662,17342,0
256,2020-02-11,구로구,399919.5193,353622.0833,22318,1785,20533,0
257,2020-02-11,금천구,239163.1133,238871.6667,15677,1274,14403,0
258,2020-02-11,노원구,531253.3047,383918.3333,18188,1859,16329,0
259,2020-02-11,도봉구,279935.7654,227639.1667,11691,992,10699,0
260,2020-02-11,동대문구,364242.3466,287263.3333,21212,1475,19737,0
261,2020-02-11,동작구,407850.5778,307482.5,15894,1581,14313,0
262,2020-02-11,마포구,476477.1363,346053.75,28419,2417,26002,0
263,2020-02-11,서대문구,378390.3243,254928.75,15024,1489,13535,0
264,2020-02-11,서초구,619614.8896,440933.75,36555,2544,34011,0
265,2020-02-11,성동구,359925.4869,262713.75,17072,1334,15738,0
266,2020-02-11,성북구,426620.5791,328121.6667,17228,1584,15644,0
267,2020-02-11,송파구,772529.5297,518801.6667,37450,3186,34264,0
268,2020-02-11,양천구,405824.2084,316680.4167,18361,1655,16706,0
269,2020-02-11,영등포구,489967.2866,417711.25,27266,2258,25008,0
270,2020-02-11,용산구,298415.3757,218975.4167,19047,1178,17869,0
271,2020-02-11,은평구,447925.3075,321215,18313,1554,16759,0
272,2020-02-11,종로구,312202.8525,246319.5833,25500,1616,23884,0
273,2020-02-11,중구,306376.1352,273605,40338,2095,38243,0
274,2020-02-11,중랑구,359352.8526,285193.75,16161,1275,14886,0
275,2020-02-12,강남구,908403.5507,655497.5,55875,4371,51504,0
276,2020-02-12,강동구,505436.4817,326317.5,20974,1901,19073,0
277,2020-02-12,강북구,307127.6245,229954.5833,13417,1075,12342,0
278,2020-02-12,강서구,552808.3753,437902.9167,25902,2633,23269,0
279,2020-02-12,관악구,492136.2172,383357.5,19734,1908,17826,0
280,2020-02-12,광진구,369272.9539,278883.3333,19004,1662,17342,0
281,2020-02-12,구로구,403279.7018,355860.8333,22318,1785,20533,0
282,2020-02-12,금천구,240037.1156,239687.9167,15677,1274,14403,0
283,2020-02-12,노원구,533786.3295,385960,18188,1859,16329,0
284,2020-02-12,도봉구,280347.8303,228699.5833,11691,992,10699,0
285,2020-02-12,동대문구,365189.7995,288010.8333,21212,1475,19737,0
286,2020-02-12,동작구,408171.8968,308212.9167,15894,1581,14313,0
287,2020-02-12,마포구,476566.2032,344895.8333,28419,2417,26002,0
288,2020-02-12,서대문구,379662.1269,254986.6667,15024,1489,13535,0
289,2020-02-12,서초구,618839.2698,440233.75,36555,2544,34011,0
290,2020-02-12,성동구,361365.1648,262950.8333,17072,1334,15738,0
291,2020-02-12,성북구,428125.0901,329717.5,17228,1584,15644,0
292,2020-02-12,송파구,773197.6343,519237.9167,37450,3186,34264,0
293,2020-02-12,양천구,407709.671,318120,18361,1655,16706,0
294,2020-02-12,영등포구,491417.6976,419107.5,27266,2258,25008,0
295,2020-02-12,용산구,299185.3534,219017.9167,19047,1178,17869,0
296,2020-02-12,은평구,449678.2017,323438.3333,18313,1554,16759,0
297,2020-02-12,종로구,307770.609,242740,25500,1616,23884,0
298,2020-02-12,중구,303059.1437,270285,40338,2095,38243,0
299,2020-02-12,중랑구,360671.0856,286385,16161,1275,14886,0
300,2020-02-13,강남구,911212.2122,658671.25,55875,4371,51504,0
301,2020-02-13,강동구,502339.6236,324140.8333,20974,1901,19073,0
302,2020-02-13,강북구,305257.0986,228452.5,13417,1075,12342,0
303,2020-02-13,강서구,550130.9396,436272.9167,25902,2633,23269,0
304,2020-02-13,관악구,488910.5913,381057.5,19734,1908,17826,0
305,2020-02-13,광진구,369192.7644,278257.0833,19004,1662,17342,0
306,2020-02-13,구로구,401378.7004,354244.1667,22318,1785,20533,0
307,2020-02-13,금천구,239093.4308,237946.6667,15677,1274,14403,0
308,2020-02-13,노원구,529835.1351,382155.4167,18188,1859,16329,0
309,2020-02-13,도봉구,278638.9114,226573.3333,11691,992,10699,0
310,2020-02-13,동대문구,364205.75,286542.0833,21212,1475,19737,0
311,2020-02-13,동작구,406809.8995,306865,15894,1581,14313,0
312,2020-02-13,마포구,479849.0869,348331.6667,28419,2417,26002,0
313,2020-02-13,서대문구,377783.6998,254076.6667,15024,1489,13535,0
314,2020-02-13,서초구,621322.576,442072.0833,36555,2544,34011,0
315,2020-02-13,성동구,359737.9078,262129.1667,17072,1334,15738,0
316,2020-02-13,성북구,426425.5629,327471.6667,17228,1584,15644,0
317,2020-02-13,송파구,774745.9591,519449.5833,37450,3186,34264,0
318,2020-02-13,양천구,406403.3764,316099.1667,18361,1655,16706,0
319,2020-02-13,영등포구,490353.5393,417957.0833,27266,2258,25008,0
320,2020-02-13,용산구,301643.8083,220297.5,19047,1178,17869,0
321,2020-02-13,은평구,446419.0499,320517.9167,18313,1554,16759,0
322,2020-02-13,종로구,313073.5897,247621.6667,25500,1616,23884,0
323,2020-02-13,중구,307713.0349,274375,40338,2095,38243,0
324,2020-02-13,중랑구,358898.1211,284926.25,16161,1275,14886,0
325,2020-02-14,강남구,909115.2564,686112.5,55875,4371,51504,0
326,2020-02-14,강동구,502896.9732,319957.0833,20974,1901,19073,0
327,2020-02-14,강북구,305505.3165,224212.9167,13417,1075,12342,0
328,2020-02-14,강서구,547097.3259,431297.5,25902,2633,23269,0
329,2020-02-14,관악구,486609.9769,370596.6667,19734,1908,17826,0
330,2020-02-14,광진구,370977.3587,273346.25,19004,1662,17342,0
331,2020-02-14,구로구,399931.5097,350270.8333,22318,1785,20533,0
332,2020-02-14,금천구,236171.9334,242211.25,15677,1274,14403,0
333,2020-02-14,노원구,528275.9701,372612.0833,18188,1859,16329,0
334,2020-02-14,도봉구,277932.6885,220426.25,11691,992,10699,0
335,2020-02-14,동대문구,362914.2357,285150,21212,1475,19737,0
336,2020-02-14,동작구,406071.414,300589.5833,15894,1581,14313,0
337,2020-02-14,마포구,484637.0856,351689.1667,28419,2417,26002,0
338,2020-02-14,서대문구,374730.149,251656.25,15024,1489,13535,0
339,2020-02-14,서초구,621896.8234,457503.75,36555,2544,34011,0
340,2020-02-14,성동구,359070.5416,263897.5,17072,1334,15738,0
341,2020-02-14,성북구,424171.1966,320577.5,17228,1584,15644,0
342,2020-02-14,송파구,773197.5771,518099.5833,37450,3186,34264,0
343,2020-02-14,양천구,405939.6653,309987.9167,18361,1655,16706,0
344,2020-02-14,영등포구,489909.7039,429467.9167,27266,2258,25008,0
345,2020-02-14,용산구,304749.14,224699.1667,19047,1178,17869,0
346,2020-02-14,은평구,444933.3519,310480.4167,18313,1554,16759,0
347,2020-02-14,종로구,312046.7538,260961.6667,25500,1616,23884,0
348,2020-02-14,중구,303708.8744,295025.4167,40338,2095,38243,0
349,2020-02-14,중랑구,357848.946,277217.0833,16161,1275,14886,0
350,2020-02-15,강남구,770575.7783,526335,55875,4371,51504,0
351,2020-02-15,강동구,516583.775,340089.5833,20974,1901,19073,0
352,2020-02-15,강북구,318021.073,244021.25,13417,1075,12342,0
353,2020-02-15,강서구,554101.894,444303.3333,25902,2633,23269,0
354,2020-02-15,관악구,514764.1652,407431.6667,19734,1908,17826,0
355,2020-02-15,광진구,383378.9235,294504.5833,19004,1662,17342,0
356,2020-02-15,구로구,392126.1783,346042.9167,22318,1785,20533,0
357,2020-02-15,금천구,209551.4114,202386.25,15677,1274,14403,0
358,2020-02-15,노원구,549465.5799,409778.75,18188,1859,16329,0
359,2020-02-15,도봉구,291377.2902,234561.6667,11691,992,10699,0
360,2020-02-15,동대문구,363097.861,288282.5,21212,1475,19737,0
361,2020-02-15,동작구,415011.7231,317477.9167,15894,1581,14313,0
362,2020-02-15,마포구,471454.0499,340566.25,28419,2417,26002,0
363,2020-02-15,서대문구,359046.9414,251272.5,15024,1489,13535,0
364,2020-02-15,서초구,554285.9857,378983.75,36555,2544,34011,0
365,2020-02-15,성동구,343230.524,244079.5833,17072,1334,15738,0
366,2020-02-15,성북구,435432.0826,339147.0833,17228,1584,15644,0
367,2020-02-15,송파구,768325.2826,513835,37450,3186,34264,0
368,2020-02-15,양천구,420193.6311,335107.0833,18361,1655,16706,0
369,2020-02-15,영등포구,437663.7244,363946.6667,27266,2258,25008,0
370,2020-02-15,용산구,292432.8644,209697.5,19047,1178,17869,0
371,2020-02-15,은평구,468207.7946,345880,18313,1554,16759,0
372,2020-02-15,종로구,266212.67,192075,25500,1616,23884,0
373,2020-02-15,중구,217920.0006,165703.3333,40338,2095,38243,0
374,2020-02-15,중랑구,375878.5522,302714.1667,16161,1275,14886,0
375,2020-02-16,강남구,715874.8308,480421.6667,55875,4371,51504,0
376,2020-02-16,강동구,527232.3178,346836.6667,20974,1901,19073,0
377,2020-02-16,강북구,326534.5278,252003.3333,13417,1075,12342,0
378,2020-02-16,강서구,560423.6506,450395.4167,25902,2633,23269,0
379,2020-02-16,관악구,525843.4888,417899.1667,19734,1908,17826,0
380,2020-02-16,광진구,384082.525,295586.25,19004,1662,17342,0
381,2020-02-16,구로구,399037.4066,352335.8333,22318,1785,20533,0
382,2020-02-16,금천구,209174.7665,203464.5833,15677,1274,14403,0
383,2020-02-16,노원구,559712.464,421090,18188,1859,16329,0
384,2020-02-16,도봉구,299710.3758,247934.5833,11691,992,10699,0
385,2020-02-16,동대문구,363929.4592,290090,21212,1475,19737,0
386,2020-02-16,동작구,416253.2486,318176.6667,15894,1581,14313,0
387,2020-02-16,마포구,454231.0117,324971.6667,28419,2417,26002,0
388,2020-02-16,서대문구,357520.2169,251298.3333,15024,1489,13535,0
389,2020-02-16,서초구,526160.7599,355502.0833,36555,2544,34011,0
390,2020-02-16,성동구,337852.2242,238780,17072,1334,15738,0
391,2020-02-16,성북구,446109.8291,347408.3333,17228,1584,15644,0
392,2020-02-16,송파구,764139.1449,511850.4167,37450,3186,34264,0
393,2020-02-16,양천구,426764.278,344307.9167,18361,1655,16706,0
394,2020-02-16,영등포구,433432.8687,358699.5833,27266,2258,25008,0
395,2020-02-16,용산구,288197.5878,203707.5,19047,1178,17869,0
396,2020-02-16,은평구,479864.043,357908.75,18313,1554,16759,0
397,2020-02-16,종로구,237070.0653,166702.9167,25500,1616,23884,2
398,2020-02-16,중구,189960.8339,140545,40338,2095,38243,0
399,2020-02-16,중랑구,385056.6624,313179.5833,16161,1275,14886,0
400,2020-02-17,강남구,893930.9319,648617.0833,55875,4371,51504,0
401,2020-02-17,강동구,506382.0072,325488.75,20974,1901,19073,0
402,2020-02-17,강북구,307006.4551,230964.1667,13417,1075,12342,0
403,2020-02-17,강서구,550701.5887,437492.9167,25902,2633,23269,0
404,2020-02-17,관악구,490828.8456,381497.5,19734,1908,17826,0
405,2020-02-17,광진구,369305.9613,278525,19004,1662,17342,0
406,2020-02-17,구로구,403705.3454,356410.8333,22318,1785,20533,0
407,2020-02-17,금천구,239454.1067,241698.75,15677,1274,14403,0
408,2020-02-17,노원구,531187.2454,383812.9167,18188,1859,16329,0
409,2020-02-17,도봉구,280428.1329,226310.4167,11691,992,10699,0
410,2020-02-17,동대문구,362012.476,286607.9167,21212,1475,19737,0
411,2020-02-17,동작구,406770.2733,306521.6667,15894,1581,14313,0
412,2020-02-17,마포구,472776.3008,345951.6667,28419,2417,26002,0
413,2020-02-17,서대문구,377674.6845,251739.5833,15024,1489,13535,0
414,2020-02-17,서초구,608556.6352,435897.0833,36555,2544,34011,0
415,2020-02-17,성동구,358686.6704,262098.3333,17072,1334,15738,0
416,2020-02-17,성북구,430658.3397,328120,17228,1584,15644,0
417,2020-02-17,송파구,774119.1033,520308.3333,37450,3186,34264,0
418,2020-02-17,양천구,406566.9235,316597.5,18361,1655,16706,0
419,2020-02-17,영등포구,486821.3621,419077.9167,27266,2258,25008,0
420,2020-02-17,용산구,297055.2438,217009.5833,19047,1178,17869,0
421,2020-02-17,은평구,449324.5407,323254.5833,18313,1554,16759,0
422,2020-02-17,종로구,300306.7661,243285.8333,25500,1616,23884,0
423,2020-02-17,중구,295872.4586,267530.8333,40338,2095,38243,0
424,2020-02-17,중랑구,361857.1545,287050.4167,16161,1275,14886,0
425,2020-02-18,강남구,913647.3066,656683.75,55875,4371,51504,0
426,2020-02-18,강동구,503109.9764,323978.3333,20974,1901,19073,0
427,2020-02-18,강북구,304851.2691,228967.0833,13417,1075,12342,0
428,2020-02-18,강서구,548368.9064,435488.3333,25902,2633,23269,0
429,2020-02-18,관악구,488102.8601,380064.5833,19734,1908,17826,0
430,2020-02-18,광진구,368279.3154,277578.75,19004,1662,17342,0
431,2020-02-18,구로구,401940.0258,353569.1667,22318,1785,20533,0
432,2020-02-18,금천구,238949.0038,238760.8333,15677,1274,14403,0
433,2020-02-18,노원구,529049.9169,380402.0833,18188,1859,16329,0
434,2020-02-18,도봉구,278376.1157,228474.5833,11691,992,10699,0
435,2020-02-18,동대문구,361971.0864,286175,21212,1475,19737,0
436,2020-02-18,동작구,405493.2384,306163.3333,15894,1581,14313,0
437,2020-02-18,마포구,478951.803,349258.75,28419,2417,26002,0
438,2020-02-18,서대문구,379497.4578,251638.3333,15024,1489,13535,0
439,2020-02-18,서초구,619813.8132,440954.5833,36555,2544,34011,0
440,2020-02-18,성동구,359819.4189,262147.5,17072,1334,15738,0
441,2020-02-18,성북구,427598.6084,326230,17228,1584,15644,0
442,2020-02-18,송파구,775035.4583,519763.3333,37450,3186,34264,0
443,2020-02-18,양천구,405818.9206,315669.5833,18361,1655,16706,0
444,2020-02-18,영등포구,491970.3044,419752.0833,27266,2258,25008,0
445,2020-02-18,용산구,299338.4159,218430.4167,19047,1178,17869,0
446,2020-02-18,은평구,444999.4341,320407.0833,18313,1554,16759,0
447,2020-02-18,종로구,308074.1432,246726.6667,25500,1616,23884,0
448,2020-02-18,중구,306106.4629,270843.75,40338,2095,38243,0
449,2020-02-18,중랑구,359190.4405,285582.9167,16161,1275,14886,0
450,2020-02-19,강남구,915731.3867,649554.5833,55875,4371,51504,0
451,2020-02-19,강동구,503166.8755,324043.3333,20974,1901,19073,0
452,2020-02-19,강북구,303581.0527,230721.6667,13417,1075,12342,0
453,2020-02-19,강서구,548100.8804,433998.3333,25902,2633,23269,0
454,2020-02-19,관악구,487434.1456,382527.0833,19734,1908,17826,0
455,2020-02-19,광진구,367860.4693,277441.25,19004,1662,17342,0
456,2020-02-19,구로구,399770.3308,352035.8333,22318,1785,20533,0
457,2020-02-19,금천구,238095.6526,235781.25,15677,1274,14403,0
458,2020-02-19,노원구,527911.4348,382076.25,18188,1859,16329,0
459,2020-02-19,도봉구,278173.2527,225042.0833,11691,992,10699,0
460,2020-02-19,동대문구,363680.8927,286945.4167,21212,1475,19737,0
461,2020-02-19,동작구,406029.7326,303852.5,15894,1581,14313,0
462,2020-02-19,마포구,477851.0664,348157.9167,28419,2417,26002,0
463,2020-02-19,서대문구,378420.215,249538.75,15024,1489,13535,0
464,2020-02-19,서초구,619528.616,431060.8333,36555,2544,34011,0
465,2020-02-19,성동구,356425.5541,257184.1667,17072,1334,15738,1
466,2020-02-19,성북구,427309.5388,326498.3333,17228,1584,15644,0
467,2020-02-19,송파구,774557.9682,516916.6667,37450,3186,34264,0
468,2020-02-19,양천구,405297.2977,316541.6667,18361,1655,16706,0
469,2020-02-19,영등포구,491668.0646,411432.5,27266,2258,25008,0
470,2020-02-19,용산구,300203.4222,216017.5,19047,1178,17869,0
471,2020-02-19,은평구,443488.202,321737.0833,18313,1554,16759,0
472,2020-02-19,종로구,310887.9858,242282.9167,25500,1616,23884,1
473,2020-02-19,중구,306368.8442,262538.75,40338,2095,38243,0
474,2020-02-19,중랑구,358449.6186,285930.8333,16161,1275,14886,0
475,2020-02-20,강남구,913643.4023,655664.5833,55875,4371,51504,0
476,2020-02-20,강동구,501329.0818,323207.9167,20974,1901,19073,0
477,2020-02-20,강북구,303460.8723,228433.3333,13417,1075,12342,0
478,2020-02-20,강서구,547521.7306,433848.3333,25902,2633,23269,0
479,2020-02-20,관악구,487124.1635,379411.6667,19734,1908,17826,0
480,2020-02-20,광진구,367791.4271,277133.3333,19004,1662,17342,0
481,2020-02-20,구로구,399283.2309,352756.25,22318,1785,20533,0
482,2020-02-20,금천구,238285.9359,237492.5,15677,1274,14403,0
483,2020-02-20,노원구,527439.0707,378695,18188,1859,16329,0
484,2020-02-20,도봉구,277345.4941,224393.3333,11691,992,10699,0
485,2020-02-20,동대문구,361508.011,285616.6667,21212,1475,19737,0
486,2020-02-20,동작구,405970.9097,305341.6667,15894,1581,14313,0
487,2020-02-20,마포구,478366.9164,348357.9167,28419,2417,26002,0
488,2020-02-20,서대문구,377480.0408,251041.6667,15024,1489,13535,0
489,2020-02-20,서초구,620573.0023,441425.8333,36555,2544,34011,0
490,2020-02-20,성동구,354638.9442,259244.1667,17072,1334,15738,1
491,2020-02-20,성북구,426736.5399,325194.1667,17228,1584,15644,0
492,2020-02-20,송파구,773746.1391,517897.9167,37450,3186,34264,0
493,2020-02-20,양천구,405188.6425,315128.75,18361,1655,16706,0
494,2020-02-20,영등포구,489652.9286,417575.8333,27266,2258,25008,0
495,2020-02-20,용산구,299991.1841,220053.75,19047,1178,17869,0
496,2020-02-20,은평구,442906.5038,319181.6667,18313,1554,16759,0
497,2020-02-20,종로구,308283.3993,245854.1667,25500,1616,23884,3
498,2020-02-20,종로구,308283.3993,245854.1667,25500,1616,23884,1
499,2020-02-20,중구,306135.3308,270260.4167,40338,2095,38243,0
500,2020-02-20,중랑구,357717.0774,283625.4167,16161,1275,14886,0
501,2020-02-21,강남구,904511.2574,648265.8333,55875,4371,51504,0
502,2020-02-21,강동구,503832.074,325403.3333,20974,1901,19073,0
503,2020-02-21,강북구,305503.132,229687.5,13417,1075,12342,0
504,2020-02-21,강서구,547511.1319,435080,25902,2633,23269,0
505,2020-02-21,관악구,487652.236,381496.25,19734,1908,17826,0
506,2020-02-21,광진구,369918.7631,279510.4167,19004,1662,17342,0
507,2020-02-21,구로구,398646.007,352611.25,22318,1785,20533,0
508,2020-02-21,금천구,235673.7017,234638.75,15677,1274,14403,0
509,2020-02-21,노원구,529839.8587,380945,18188,1859,16329,0
510,2020-02-21,도봉구,278844.3237,227098.3333,11691,992,10699,0
511,2020-02-21,동대문구,361651.363,285637.5,21212,1475,19737,0
512,2020-02-21,동작구,406598.5917,305827.9167,15894,1581,14313,0
513,2020-02-21,마포구,479014.5397,349612.5,28419,2417,26002,0
514,2020-02-21,서대문구,375438.2044,251139.1667,15024,1489,13535,1
515,2020-02-21,서초구,616055.3404,438256.25,36555,2544,34011,1
516,2020-02-21,성동구,353036.0369,257995.4167,17072,1334,15738,0
517,2020-02-21,성북구,427179.198,326154.5833,17228,1584,15644,0
518,2020-02-21,송파구,771213.688,518340.4167,37450,3186,34264,0
519,2020-02-21,양천구,406563.716,317391.6667,18361,1655,16706,0
520,2020-02-21,영등포구,487424.8658,416391.6667,27266,2258,25008,0
521,2020-02-21,용산구,300763.7667,220233.75,19047,1178,17869,0
522,2020-02-21,은평구,443987.051,320527.5,18313,1554,16759,0
523,2020-02-21,종로구,299326.6749,237838.3333,25500,1616,23884,0
524,2020-02-21,중구,297484.7337,257737.0833,40338,2095,38243,0
525,2020-02-21,중랑구,359247.476,285630,16161,1275,14886,0
526,2020-02-22,강남구,762714.178,518584.5833,55875,4371,51504,0
527,2020-02-22,강동구,522145.6078,343202.5,20974,1901,19073,1
528,2020-02-22,강북구,321497.8874,245714.1667,13417,1075,12342,0
529,2020-02-22,강서구,555361.7934,445961.6667,25902,2633,23269,0
530,2020-02-22,관악구,519290.7235,411375.8333,19734,1908,17826,0
531,2020-02-22,광진구,381526.6283,294662.9167,19004,1662,17342,0
532,2020-02-22,구로구,393395.8262,349105.8333,22318,1785,20533,1
533,2020-02-22,금천구,209065.6522,203848.3333,15677,1274,14403,0
534,2020-02-22,노원구,555289.2147,413021.25,18188,1859,16329,0
535,2020-02-22,도봉구,293726.391,233282.9167,11691,992,10699,0
536,2020-02-22,동대문구,362482.9089,288788.75,21212,1475,19737,0
537,2020-02-22,동작구,418376.9206,317514.1667,15894,1581,14313,0
538,2020-02-22,마포구,460670.9943,333135.8333,28419,2417,26002,0
539,2020-02-22,서대문구,359588.6662,251242.5,15024,1489,13535,0
540,2020-02-22,서초구,542825.4802,370240.8333,36555,2544,34011,2
541,2020-02-22,성동구,337861.4944,240801.25,17072,1334,15738,0
542,2020-02-22,성북구,441382.0381,342675.4167,17228,1584,15644,0
543,2020-02-22,송파구,768638.8194,514247.5,37450,3186,34264,0
544,2020-02-22,양천구,423505.6484,339710.8333,18361,1655,16706,0
545,2020-02-22,영등포구,432692.8773,361057.0833,27266,2258,25008,0
546,2020-02-22,용산구,285151.146,204638.75,19047,1178,17869,0
547,2020-02-22,은평구,471925.718,349934.1667,18313,1554,16759,0
548,2020-02-22,종로구,243950.5252,174273.75,25500,1616,23884,0
549,2020-02-22,중구,205697.7871,155042.9167,40338,2095,38243,0
550,2020-02-22,중랑구,378699.7582,306347.0833,16161,1275,14886,0
551,2020-02-23,강남구,704692.3479,919984.1667,55875,4371,51504,0
552,2020-02-23,강동구,528327.0229,679347.0833,20974,1901,19073,0
553,2020-02-23,강북구,328576.1223,494629.1667,13417,1075,12342,0
554,2020-02-23,강서구,561096.5119,880487.0833,25902,2633,23269,1
555,2020-02-23,관악구,530358.1684,825088.3333,19734,1908,17826,0
556,2020-02-23,광진구,382745.4846,579637.5,19004,1662,17342,0
557,2020-02-23,구로구,396751.4198,690929.5833,22318,1785,20533,0
558,2020-02-23,금천구,209601.549,400754.1667,15677,1274,14403,0
559,2020-02-23,노원구,562501.7423,823629.5833,18188,1859,16329,0
560,2020-02-23,도봉구,301259.2319,485168.3333,11691,992,10699,0
561,2020-02-23,동대문구,361606.2115,563321.25,21212,1475,19737,0
562,2020-02-23,동작구,420836.3257,623912.0833,15894,1581,14313,0
563,2020-02-23,마포구,449498.632,631715.4167,28419,2417,26002,0
564,2020-02-23,서대문구,358768.2228,491506.6667,15024,1489,13535,0
565,2020-02-23,서초구,510075.2335,670742.0833,36555,2544,34011,0
566,2020-02-23,성동구,334978.3047,465342.5,17072,1334,15738,0
567,2020-02-23,성북구,449441.5048,683321.25,17228,1584,15644,0
568,2020-02-23,송파구,762935.6083,996560.4167,37450,3186,34264,2
569,2020-02-23,양천구,428003.2245,678063.3333,18361,1655,16706,0
570,2020-02-23,영등포구,420206.1296,684137.9167,27266,2258,25008,0
571,2020-02-23,용산구,278350.1214,389702.0833,19047,1178,17869,0
572,2020-02-23,은평구,481820.4904,704817.0833,18313,1554,16759,0
573,2020-02-23,종로구,225445.703,306086.6667,25500,1616,23884,1
574,2020-02-23,중구,182477.5123,261819.1667,40338,2095,38243,0
575,2020-02-23,중랑구,385201.2196,614611.6667,16161,1275,14886,0
576,2020-02-24,강남구,871269.8912,628574.1667,55875,4371,51504,0
577,2020-02-24,강동구,508820.4317,326780.4167,20974,1901,19073,0
578,2020-02-24,강북구,308431.062,231506.6667,13417,1075,12342,0
579,2020-02-24,강서구,550183.1032,438377.9167,25902,2633,23269,0
580,2020-02-24,관악구,493523.4009,383940.8333,19734,1908,17826,1
581,2020-02-24,광진구,366728.9258,278108.75,19004,1662,17342,0
582,2020-02-24,구로구,402192.3889,356613.75,22318,1785,20533,0
583,2020-02-24,금천구,239672.7286,240755,15677,1274,14403,0
584,2020-02-24,노원구,532170.7739,383789.5833,18188,1859,16329,0
585,2020-02-24,도봉구,282426.536,230642.5,11691,992,10699,0
586,2020-02-24,동대문구,360595.7254,285597.0833,21212,1475,19737,0
587,2020-02-24,동작구,406631.1308,304455,15894,1581,14313,0
588,2020-02-24,마포구,466625.995,341835,28419,2417,26002,0
589,2020-02-24,서대문구,374157.9304,250886.6667,15024,1489,13535,0
590,2020-02-24,서초구,599719.3387,427870.8333,36555,2544,34011,0
591,2020-02-24,성동구,354909.4492,259555.8333,17072,1334,15738,0
592,2020-02-24,성북구,431672.0122,329716.25,17228,1584,15644,0
593,2020-02-24,송파구,770987.1225,517430,37450,3186,34264,2
594,2020-02-24,양천구,408418.3739,320160,18361,1655,16706,0
595,2020-02-24,영등포구,482264.4983,413982.9167,27266,2258,25008,0
596,2020-02-24,용산구,293704.7137,215112.0833,19047,1178,17869,0
597,2020-02-24,은평구,448378.3072,324607.5,18313,1554,16759,0
598,2020-02-24,종로구,289929.6437,229834.5833,25500,1616,23884,1
599,2020-02-24,중구,287647.6552,255222.9167,40338,2095,38243,0
600,2020-02-24,중랑구,361946.0171,289205.4167,16161,1275,14886,0
601,2020-02-25,강남구,869160.6342,624662.0833,55875,4371,51504,0
602,2020-02-25,강동구,509614.6713,328310,20974,1901,19073,1
603,2020-02-25,강북구,309627.1688,232710.8333,13417,1075,12342,0
604,2020-02-25,강서구,552623.1275,440338.75,25902,2633,23269,0
605,2020-02-25,관악구,494859.8653,386692.0833,19734,1908,17826,0
606,2020-02-25,광진구,365935.1034,278522.0833,19004,1662,17342,0
607,2020-02-25,구로구,404155.9782,357410.4167,22318,1785,20533,0
608,2020-02-25,금천구,240429.0095,240240.4167,15677,1274,14403,1
609,2020-02-25,노원구,532223.7165,384378.75,18188,1859,16329,2
610,2020-02-25,도봉구,283073.3336,234543.75,11691,992,10699,0
611,2020-02-25,동대문구,361327.1648,286412.0833,21212,1475,19737,0
612,2020-02-25,동작구,405107.659,303207.9167,15894,1581,14313,1
613,2020-02-25,마포구,466614.6956,342053.75,28419,2417,26002,0
614,2020-02-25,서대문구,373944.7559,250120.8333,15024,1489,13535,1
615,2020-02-25,서초구,596012.3335,424820,36555,2544,34011,0
616,2020-02-25,성동구,357575.496,260668.3333,17072,1334,15738,0
617,2020-02-25,성북구,433561.5231,331747.0833,17228,1584,15644,0
618,2020-02-25,송파구,771394.2479,519331.6667,37450,3186,34264,4
619,2020-02-25,양천구,407854.4051,322053.3333,18361,1655,16706,0
620,2020-02-25,영등포구,480554.8427,411135.8333,27266,2258,25008,0
621,2020-02-25,용산구,288606.6718,211162.9167,19047,1178,17869,0
622,2020-02-25,은평구,449712.1126,326050.8333,18313,1554,16759,2
623,2020-02-25,종로구,288479.9347,227488.75,25500,1616,23884,1
624,2020-02-25,종로구,288479.9347,227488.75,25500,1616,23884,3
625,2020-02-25,중구,286064.7026,249597.5,40338,2095,38243,0
626,2020-02-25,중랑구,362786.6646,290538.75,16161,1275,14886,0
627,2020-02-26,강남구,864191.3765,618678.75,55875,4371,51504,2
628,2020-02-26,강동구,509609.0117,327925.4167,20974,1901,19073,2
629,2020-02-26,강북구,309263.0124,231007.9167,13417,1075,12342,0
630,2020-02-26,강서구,552503.4487,438769.1667,25902,2633,23269,0
631,2020-02-26,관악구,497147.2354,386786.25,19734,1908,17826,1
632,2020-02-26,광진구,367121.0494,278408.3333,19004,1662,17342,0
633,2020-02-26,구로구,403920.0455,356199.5833,22318,1785,20533,0
634,2020-02-26,금천구,239117.4607,238370.4167,15677,1274,14403,0
635,2020-02-26,노원구,531193.1915,382530.8333,18188,1859,16329,0
636,2020-02-26,도봉구,283980.0436,234574.5833,11691,992,10699,0
637,2020-02-26,동대문구,362512.7882,286659.1667,21212,1475,19737,0
638,2020-02-26,동작구,406007.2421,302947.5,15894,1581,14313,0
639,2020-02-26,마포구,468891.6694,342836.6667,28419,2417,26002,0
640,2020-02-26,서대문구,373523.1268,250480.8333,15024,1489,13535,0
641,2020-02-26,서초구,596583.2386,423456.25,36555,2544,34011,0
642,2020-02-26,성동구,359918.6831,261002.5,17072,1334,15738,0
643,2020-02-26,성북구,433825.1181,331912.9167,17228,1584,15644,0
644,2020-02-26,송파구,771603.8825,518152.0833,37450,3186,34264,0
645,2020-02-26,양천구,407364.2487,321200.8333,18361,1655,16706,1
646,2020-02-26,영등포구,483618.0868,413030.4167,27266,2258,25008,0
647,2020-02-26,용산구,289922.6728,211724.1667,19047,1178,17869,0
648,2020-02-26,은평구,449529.0406,325105,18313,1554,16759,4
649,2020-02-26,종로구,289850.4789,226901.25,25500,1616,23884,0
650,2020-02-26,중구,285255.9039,245089.5833,40338,2095,38243,0
651,2020-02-26,중랑구,362321.7385,288840,16161,1275,14886,0
652,2020-02-27,강남구,853177.3742,612268.3333,55875,4371,51504,2
653,2020-02-27,강동구,508644.8572,328370,20974,1901,19073,0
654,2020-02-27,강북구,309015.2704,231466.25,13417,1075,12342,0
655,2020-02-27,강서구,551829.5976,438226.25,25902,2633,23269,0
656,2020-02-27,관악구,496323.2877,386184.5833,19734,1908,17826,1
657,2020-02-27,광진구,367280.3364,278801.6667,19004,1662,17342,1
658,2020-02-27,구로구,402913.1378,355517.0833,22318,1785,20533,0
659,2020-02-27,금천구,237540.3525,236746.25,15677,1274,14403,0
660,2020-02-27,노원구,530349.9158,382291.6667,18188,1859,16329,3
661,2020-02-27,도봉구,283476.4964,232708.3333,11691,992,10699,0
662,2020-02-27,동대문구,361037.5875,286547.9167,21212,1475,19737,1
663,2020-02-27,동작구,404806.0823,302501.6667,15894,1581,14313,0
664,2020-02-27,마포구,467776.2446,342325.8333,28419,2417,26002,0
665,2020-02-27,서대문구,372094.366,249455,15024,1489,13535,0
666,2020-02-27,서초구,592321.9846,421281.25,36555,2544,34011,0
667,2020-02-27,성동구,358833.1888,261497.5,17072,1334,15738,0
668,2020-02-27,성북구,432933.5874,331342.0833,17228,1584,15644,0
669,2020-02-27,송파구,770154.2146,517356.6667,37450,3186,34264,3
670,2020-02-27,양천구,407305.5135,321585.8333,18361,1655,16706,0
671,2020-02-27,영등포구,480107.2317,409538.3333,27266,2258,25008,1
672,2020-02-27,용산구,291386.895,213177.0833,19047,1178,17869,0
673,2020-02-27,은평구,449027.7717,324638.75,18313,1554,16759,1
674,2020-02-27,종로구,286964.8364,225294.5833,25500,1616,23884,0
675,2020-02-27,중구,283315.4847,242450.8333,40338,2095,38243,0
676,2020-02-27,중랑구,362807.353,288762.5,16161,1275,14886,0
677,2020-02-28,강남구,845084.4616,600506.25,55875,4371,51504,2
678,2020-02-28,강동구,511806.4119,331470,20974,1901,19073,0
679,2020-02-28,강북구,308627.2025,233369.1667,13417,1075,12342,0
680,2020-02-28,강서구,552821.2434,439687.0833,25902,2633,23269,0
681,2020-02-28,관악구,498623.9895,389726.25,19734,1908,17826,1
682,2020-02-28,광진구,369750.1528,281080.4167,19004,1662,17342,0
683,2020-02-28,구로구,403791.9661,357130.8333,22318,1785,20533,0
684,2020-02-28,금천구,236179.9322,234799.5833,15677,1274,14403,0
685,2020-02-28,노원구,534880.2352,385225,18188,1859,16329,2
686,2020-02-28,도봉구,282248.2685,237008.75,11691,992,10699,0
687,2020-02-28,동대문구,361524.865,286893.3333,21212,1475,19737,0
688,2020-02-28,동작구,407390.8837,305521.25,15894,1581,14313,0
689,2020-02-28,마포구,466167.0418,339457.0833,28419,2417,26002,0
690,2020-02-28,서대문구,370111.2131,250603.3333,15024,1489,13535,1
691,2020-02-28,서초구,586734.6055,414488.75,36555,2544,34011,1
692,2020-02-28,성동구,357240.2154,260605,17072,1334,15738,0
693,2020-02-28,성북구,435510.5493,333598.75,17228,1584,15644,0
694,2020-02-28,송파구,770663.1493,519200.8333,37450,3186,34264,0
695,2020-02-28,양천구,409754.8038,324917.0833,18361,1655,16706,0
696,2020-02-28,영등포구,475944.6538,405956.25,27266,2258,25008,0
697,2020-02-28,용산구,291603.2552,213670.4167,19047,1178,17869,0
698,2020-02-28,은평구,451565.0555,328140.8333,18313,1554,16759,0
699,2020-02-28,종로구,279668.6202,217010.8333,25500,1616,23884,1
700,2020-02-28,중구,275617.9475,231971.25,40338,2095,38243,0
701,2020-02-28,중랑구,365472.8336,291247.0833,16161,1275,14886,0
702,2020-02-29,강남구,717127.5359,496175.8333,55875,4371,51504,1
703,2020-02-29,강동구,523401.6956,346605.4167,20974,1901,19073,0
704,2020-02-29,강북구,324857.2712,252679.5833,13417,1075,12342,0
705,2020-02-29,강서구,560456.3449,454192.0833,25902,2633,23269,0
706,2020-02-29,관악구,522893.4133,418964.1667,19734,1908,17826,0
707,2020-02-29,광진구,379370.1381,296472.5,19004,1662,17342,0
708,2020-02-29,구로구,395363.2353,355761.25,22318,1785,20533,0
709,2020-02-29,금천구,212110.5703,208468.75,15677,1274,14403,0
710,2020-02-29,노원구,556102.7101,419671.6667,18188,1859,16329,1
711,2020-02-29,도봉구,298751.8685,258049.5833,11691,992,10699,0
712,2020-02-29,동대문구,361207.2858,294870.4167,21212,1475,19737,0
713,2020-02-29,동작구,417780.0916,321917.5,15894,1581,14313,0
714,2020-02-29,마포구,448972.8155,329261.25,28419,2417,26002,0
715,2020-02-29,서대문구,357192.6045,256849.1667,15024,1489,13535,0
716,2020-02-29,서초구,519804.7568,359273.75,36555,2544,34011,0
717,2020-02-29,성동구,340228.7738,246041.25,17072,1334,15738,1
718,2020-02-29,성북구,447098.9074,353524.5833,17228,1584,15644,1
719,2020-02-29,송파구,762439.6414,518080.4167,37450,3186,34264,0
720,2020-02-29,양천구,425239.3065,347927.9167,18361,1655,16706,0
721,2020-02-29,영등포구,422244.0535,356994.5833,27266,2258,25008,1
722,2020-02-29,용산구,274985.5331,202177.5,19047,1178,17869,0
723,2020-02-29,은평구,476373.4213,358059.1667,18313,1554,16759,0
724,2020-02-29,종로구,230006.1039,164938.75,25500,1616,23884,0
725,2020-02-29,중구,191580.7274,145485.8333,40338,2095,38243,0
726,2020-02-29,중랑구,381921.9731,312845,16161,1275,14886,0
727,2020-03-01,강남구,675456.985,459757.9167,55875,4371,51504,2
728,2020-03-01,강동구,528754.9911,349955.8333,20974,1901,19073,0
729,2020-03-01,강북구,330991.0393,257551.25,13417,1075,12342,0
730,2020-03-01,강서구,563620.4035,456141.25,25902,2633,23269,0
731,2020-03-01,관악구,531611.7716,426080.4167,19734,1908,17826,0
732,2020-03-01,광진구,381096.418,297989.1667,19004,1662,17342,1
733,2020-03-01,구로구,398873.8283,360350.8333,22318,1785,20533,0
734,2020-03-01,금천구,211496.7797,208322.9167,15677,1274,14403,0
735,2020-03-01,노원구,564919.0067,427170,18188,1859,16329,0
736,2020-03-01,도봉구,305109.8479,265892.5,11691,992,10699,0
737,2020-03-01,동대문구,359700.5038,293608.3333,21212,1475,19737,1
738,2020-03-01,동작구,419864.0181,322602.5,15894,1581,14313,0
739,2020-03-01,마포구,437519.6868,319327.0833,28419,2417,26002,0
740,2020-03-01,서대문구,355449.9655,255519.1667,15024,1489,13535,0
741,2020-03-01,서초구,499923.7843,341271.6667,36555,2544,34011,0
742,2020-03-01,성동구,335360.9719,240827.0833,17072,1334,15738,0
743,2020-03-01,성북구,453223.717,358846.25,17228,1584,15644,0
744,2020-03-01,송파구,758403.9298,514161.25,37450,3186,34264,0
745,2020-03-01,양천구,430082.789,353299.1667,18361,1655,16706,1
746,2020-03-01,영등포구,414539.6724,349143.3333,27266,2258,25008,0
747,2020-03-01,용산구,268408.3215,196536.6667,19047,1178,17869,0
748,2020-03-01,은평구,485678.9565,366809.5833,18313,1554,16759,0
749,2020-03-01,종로구,215001.469,150795.8333,25500,1616,23884,0
750,2020-03-01,중구,169415.8934,125807.0833,40338,2095,38243,0
751,2020-03-01,중랑구,389092.8501,320014.5833,16161,1275,14886,1
752,2020-03-02,강남구,835712.6514,611897.9167,55875,4371,51504,0
753,2020-03-02,강동구,516190.8536,333307.0833,20974,1901,19073,0
754,2020-03-02,강북구,311674.857,236109.1667,13417,1075,12342,0
755,2020-03-02,강서구,552861.4436,443752.5,25902,2633,23269,0
756,2020-03-02,관악구,496472.7838,389716.6667,19734,1908,17826,0
757,2020-03-02,광진구,368953.8384,282414.5833,19004,1662,17342,0
758,2020-03-02,구로구,404198.4294,363485.4167,22318,1785,20533,0
759,2020-03-02,금천구,237202.4825,241245.4167,15677,1274,14403,0
760,2020-03-02,노원구,534234.0998,389926.6667,18188,1859,16329,0
761,2020-03-02,도봉구,285359.1552,239714.5833,11691,992,10699,1
762,2020-03-02,동대문구,361698.3257,292572.5,21212,1475,19737,0
763,2020-03-02,동작구,408759.0482,310615.8333,15894,1581,14313,0
764,2020-03-02,마포구,461351.1505,343107.5,28419,2417,26002,0
765,2020-03-02,서대문구,369489.6269,254712.0833,15024,1489,13535,0
766,2020-03-02,서초구,586006.4351,424345,36555,2544,34011,1
767,2020-03-02,성동구,355947.6788,265632.9167,17072,1334,15738,0
768,2020-03-02,성북구,435872.3934,338883.3333,17228,1584,15644,2
769,2020-03-02,송파구,767215.5829,522425,37450,3186,34264,0
770,2020-03-02,양천구,410879.2712,327370.4167,18361,1655,16706,0
771,2020-03-02,영등포구,473710.7015,410811.25,27266,2258,25008,2
772,2020-03-02,용산구,288925.2513,215420.8333,19047,1178,17869,0
773,2020-03-02,은평구,452032.2365,330030,18313,1554,16759,0
774,2020-03-02,종로구,276473.2509,221510.8333,25500,1616,23884,0
775,2020-03-02,중구,272053.5723,240567.0833,40338,2095,38243,0
776,2020-03-02,중랑구,365999.1523,293892.0833,16161,1275,14886,0
777,2020-03-03,강남구,843711.2104,616457.5,55875,4371,51504,0
778,2020-03-03,강동구,512432.4625,331779.5833,20974,1901,19073,0
779,2020-03-03,강북구,310214.3871,234619.5833,13417,1075,12342,0
780,2020-03-03,강서구,551476.6514,442554.1667,25902,2633,23269,0
781,2020-03-03,관악구,495015.0466,388125.8333,19734,1908,17826,0
782,2020-03-03,광진구,367568.64,281278.75,19004,1662,17342,0
783,2020-03-03,구로구,402060.7018,361675,22318,1785,20533,0
784,2020-03-03,금천구,236409.9709,239792.0833,15677,1274,14403,0
785,2020-03-03,노원구,533366.7791,388960,18188,1859,16329,0
786,2020-03-03,도봉구,283811.6129,237772.5,11691,992,10699,0
787,2020-03-03,동대문구,361005.4376,292180.4167,21212,1475,19737,1
788,2020-03-03,동작구,407828.847,309709.1667,15894,1581,14313,0
789,2020-03-03,마포구,464369.7994,344285,28419,2417,26002,0
790,2020-03-03,서대문구,370095.9404,253604.5833,15024,1489,13535,0
791,2020-03-03,서초구,585984.108,425804.1667,36555,2544,34011,0
792,2020-03-03,성동구,357781.4667,265876.6667,17072,1334,15738,0
793,2020-03-03,성북구,433778.526,336894.5833,17228,1584,15644,0
794,2020-03-03,송파구,771982.0896,524090.4167,37450,3186,34264,0
795,2020-03-03,양천구,410904.6348,325582.9167,18361,1655,16706,0
796,2020-03-03,영등포구,473402.5707,409181.25,27266,2258,25008,0
797,2020-03-03,용산구,290066.4404,216075.4167,19047,1178,17869,0
798,2020-03-03,은평구,451019.1135,327987.5,18313,1554,16759,0
799,2020-03-03,종로구,279764.7411,224632.5,25500,1616,23884,0
800,2020-03-03,중구,275137.7252,243559.5833,40338,2095,38243,0
801,2020-03-03,중랑구,363220.1427,291557.0833,16161,1275,14886,0
802,2020-03-04,강남구,844003.6847,609761.25,55875,4371,51504,0
803,2020-03-04,강동구,513296.478,333072.5,20974,1901,19073,0
804,2020-03-04,강북구,312185.9742,235705,13417,1075,12342,2
805,2020-03-04,강서구,551930.0288,443375,25902,2633,23269,0
806,2020-03-04,관악구,497083.3825,390044.5833,19734,1908,17826,0
807,2020-03-04,광진구,366357.4183,281722.5,19004,1662,17342,0
808,2020-03-04,구로구,396746.1709,360700.8333,22318,1785,20533,0
809,2020-03-04,금천구,236934.5868,238200.8333,15677,1274,14403,0
810,2020-03-04,노원구,532296.5345,391801.25,18188,1859,16329,0
811,2020-03-04,도봉구,284103.2685,238432.9167,11691,992,10699,0
812,2020-03-04,동대문구,360278.7788,292465.8333,21212,1475,19737,1
813,2020-03-04,동작구,405793.5153,310002.9167,15894,1581,14313,0
814,2020-03-04,마포구,464759.2088,342950.8333,28419,2417,26002,0
815,2020-03-04,서대문구,370731.6717,253987.5,15024,1489,13535,0
816,2020-03-04,서초구,586020.2113,421988.75,36555,2544,34011,0
817,2020-03-04,성동구,356071.0102,264332.0833,17072,1334,15738,0
818,2020-03-04,성북구,432347.8191,337796.6667,17228,1584,15644,0
819,2020-03-04,송파구,772668.3754,523304.1667,37450,3186,34264,0
820,2020-03-04,양천구,411018.8419,326182.0833,18361,1655,16706,0
821,2020-03-04,영등포구,474856.074,407622.5,27266,2258,25008,0
822,2020-03-04,용산구,287568.1056,214814.1667,19047,1178,17869,1
823,2020-03-04,은평구,451197.0337,330290.8333,18313,1554,16759,0
824,2020-03-04,종로구,280234.7565,220520,25500,1616,23884,0
825,2020-03-04,중구,274299.1102,236885,40338,2095,38243,0
826,2020-03-04,중랑구,363353.2513,293232.0833,16161,1275,14886,1
827,2020-03-06,강남구,843072.6796,609145.4167,55875,4371,51504,2
828,2020-03-06,강동구,511709.5582,333151.25,20974,1901,19073,0
829,2020-03-06,강북구,309440.2417,234928.75,13417,1075,12342,0
830,2020-03-06,강서구,550115.2396,442093.3333,25902,2633,23269,1
831,2020-03-06,관악구,492135.4766,388977.9167,19734,1908,17826,0
832,2020-03-06,광진구,368161.7987,282618.75,19004,1662,17342,0
833,2020-03-06,구로구,403180.1175,359417.0833,22318,1785,20533,0
834,2020-03-06,금천구,235120.2923,235027.9167,15677,1274,14403,0
835,2020-03-06,노원구,532308.388,390497.5,18188,1859,16329,0
836,2020-03-06,도봉구,282610.4037,237488.3333,11691,992,10699,0
837,2020-03-06,동대문구,359132.0619,290140,21212,1475,19737,0
838,2020-03-06,동작구,408795.163,309267.5,15894,1581,14313,0
839,2020-03-06,마포구,465944.9404,345360.8333,28419,2417,26002,0
840,2020-03-06,서대문구,369917.1998,253268.75,15024,1489,13535,0
841,2020-03-06,서초구,583643.6885,421975.8333,36555,2544,34011,0
842,2020-03-06,성동구,356974.1715,263332.0833,17072,1334,15738,0
843,2020-03-06,성북구,433068.3996,335944.5833,17228,1584,15644,1
844,2020-03-06,송파구,770023.9235,522292.9167,37450,3186,34264,0
845,2020-03-06,양천구,409637.3553,325164.5833,18361,1655,16706,0
846,2020-03-06,영등포구,473638.8208,406696.25,27266,2258,25008,0
847,2020-03-06,용산구,292116.3535,216263.75,19047,1178,17869,0
848,2020-03-06,은평구,447289.8355,328760.4167,18313,1554,16759,1
849,2020-03-06,종로구,277489.0031,219106.6667,25500,1616,23884,0
850,2020-03-06,중구,271830.3247,234586.6667,40338,2095,38243,0
851,2020-03-06,중랑구,362476.9303,292071.6667,16161,1275,14886,2
852,2020-03-07,강남구,719355.8751,498416.25,55875,4371,51504,0
853,2020-03-07,강동구,525564.0174,345827.0833,20974,1901,19073,0
854,2020-03-07,강북구,322139.3089,251055.8333,13417,1075,12342,1
855,2020-03-07,강서구,557414.4168,449504.5833,25902,2633,23269,0
856,2020-03-07,관악구,519815.6006,415381.25,19734,1908,17826,1
857,2020-03-07,광진구,378400.7968,295215.8333,19004,1662,17342,0
858,2020-03-07,구로구,390147.3834,353806.25,22318,1785,20533,0
859,2020-03-07,금천구,210449.191,205577.0833,15677,1274,14403,0
860,2020-03-07,노원구,554953.0719,417142.9167,18188,1859,16329,0
861,2020-03-07,도봉구,296572.7003,253888.3333,11691,992,10699,0
862,2020-03-07,동대문구,357573.7635,289629.5833,21212,1475,19737,0
863,2020-03-07,동작구,414255.6723,318464.1667,15894,1581,14313,0
864,2020-03-07,마포구,448702.9185,333296.6667,28419,2417,26002,0
865,2020-03-07,서대문구,355922.9743,253030,15024,1489,13535,0
866,2020-03-07,서초구,521074.8438,357174.5833,36555,2544,34011,1
867,2020-03-07,성동구,338382.8141,242346.6667,17072,1334,15738,0
868,2020-03-07,성북구,444557.8563,347830.8333,17228,1584,15644,0
869,2020-03-07,송파구,758753.3571,513697.9167,37450,3186,34264,0
870,2020-03-07,양천구,423290.713,342014.5833,18361,1655,16706,3
871,2020-03-07,영등포구,423021.0333,354610.8333,27266,2258,25008,0
872,2020-03-07,용산구,274677.4385,201900.8333,19047,1178,17869,0
873,2020-03-07,은평구,473758.7199,354379.1667,18313,1554,16759,0
874,2020-03-07,종로구,231309.688,165700,25500,1616,23884,0
875,2020-03-07,중구,191358.8015,146346.25,40338,2095,38243,0
876,2020-03-07,중랑구,378455.463,309278.3333,16161,1275,14886,1
877,2020-03-08,강남구,675886.9842,456883.75,55875,4371,51504,1
878,2020-03-08,강동구,527186.0294,346700,20974,1901,19073,0
879,2020-03-08,강북구,327720.5647,254432.5,13417,1075,12342,0
880,2020-03-08,강서구,559351.3451,451340.4167,25902,2633,23269,0
881,2020-03-08,관악구,527643.2385,421726.25,19734,1908,17826,0
882,2020-03-08,광진구,379228.4003,295605.4167,19004,1662,17342,0
883,2020-03-08,구로구,391254.1405,353806.25,22318,1785,20533,0
884,2020-03-08,금천구,209544.7409,204821.25,15677,1274,14403,0
885,2020-03-08,노원구,559847.5857,422510.8333,18188,1859,16329,1
886,2020-03-08,도봉구,302292.7261,262267.9167,11691,992,10699,0
887,2020-03-08,동대문구,355175.5859,289114.1667,21212,1475,19737,7
888,2020-03-08,동작구,416149.7773,319277.9167,15894,1581,14313,0
889,2020-03-08,마포구,439502.5937,320609.5833,28419,2417,26002,0
890,2020-03-08,서대문구,354307.7223,252850,15024,1489,13535,0
891,2020-03-08,서초구,499814.8683,339305.8333,36555,2544,34011,0
892,2020-03-08,성동구,333323.5391,238223.75,17072,1334,15738,0
893,2020-03-08,성북구,448399.9374,352890,17228,1584,15644,0
894,2020-03-08,송파구,755054.5361,509782.5,37450,3186,34264,0
895,2020-03-08,양천구,424949.0231,347490.4167,18361,1655,16706,0
896,2020-03-08,영등포구,414669.8156,346940.4167,27266,2258,25008,0
897,2020-03-08,용산구,269108.8862,196122.0833,19047,1178,17869,0
898,2020-03-08,은평구,480000.25,361981.25,18313,1554,16759,0
899,2020-03-08,종로구,217536.795,152565.8333,25500,1616,23884,0
900,2020-03-08,중구,170224.1906,125085.4167,40338,2095,38243,0
901,2020-03-08,중랑구,383267.5388,314055.8333,16161,1275,14886,1
902,2020-03-09,강남구,846622.883,614540.4167,55875,4371,51504,0
903,2020-03-09,강동구,512580.5196,331632.9167,20974,1901,19073,1
904,2020-03-09,강북구,308831.2181,234457.5,13417,1075,12342,0
905,2020-03-09,강서구,551248.5208,442119.1667,25902,2633,23269,3
906,2020-03-09,관악구,495061.2161,388835.4167,19734,1908,17826,0
907,2020-03-09,광진구,367712.6183,281279.1667,19004,1662,17342,0
908,2020-03-09,구로구,400942.6362,361489.5833,22318,1785,20533,8
909,2020-03-09,금천구,236204.4581,237725.8333,15677,1274,14403,1
910,2020-03-09,노원구,532789.3932,389437.5,18188,1859,16329,1
911,2020-03-09,도봉구,283315.8541,237900,11691,992,10699,0
912,2020-03-09,동대문구,358769.6718,289944.1667,21212,1475,19737,0
913,2020-03-09,동작구,404521.1494,307533.3333,15894,1581,14313,1
914,2020-03-09,마포구,462627.0019,343117.0833,28419,2417,26002,0
915,2020-03-09,서대문구,369311.7959,252772.9167,15024,1489,13535,0
916,2020-03-09,서초구,587674.055,424971.25,36555,2544,34011,0
917,2020-03-09,성동구,354439.3995,262487.5,17072,1334,15738,0
918,2020-03-09,성북구,433739.4556,336260,17228,1584,15644,0
919,2020-03-09,송파구,770248.3899,522231.6667,37450,3186,34264,0
920,2020-03-09,양천구,408655.7368,323932.5,18361,1655,16706,2
921,2020-03-09,영등포구,479386.1004,410975.4167,27266,2258,25008,0
922,2020-03-09,용산구,289462.5765,215244.5833,19047,1178,17869,0
923,2020-03-09,은평구,450297.8429,328383.3333,18313,1554,16759,4
924,2020-03-09,종로구,279546.0687,222533.3333,25500,1616,23884,0
925,2020-03-09,중구,272977.4161,238962.0833,40338,2095,38243,1
926,2020-03-09,중랑구,362749.2753,292137.9167,16161,1275,14886,4
927,2020-03-10,강남구,855118.3571,617367.5,55875,4371,51504,0
928,2020-03-10,강동구,514162.912,333260,20974,1901,19073,0
929,2020-03-10,강북구,310187.5289,235353.75,13417,1075,12342,0
930,2020-03-10,강서구,552338.8469,442983.75,25902,2633,23269,4
931,2020-03-10,관악구,496137.8094,389979.5833,19734,1908,17826,8
932,2020-03-10,광진구,366944.8884,283340.8333,19004,1662,17342,0
933,2020-03-10,구로구,400858.0203,360747.9167,22318,1785,20533,5
934,2020-03-10,금천구,237011.9167,237659.5833,15677,1274,14403,1
935,2020-03-10,노원구,533065.7004,390248.3333,18188,1859,16329,2
936,2020-03-10,도봉구,283809.4104,238744.5833,11691,992,10699,0
937,2020-03-10,동대문구,359537.4384,291300.4167,21212,1475,19737,4
938,2020-03-10,동작구,405733.8311,308157.5,15894,1581,14313,3
939,2020-03-10,마포구,462920.2553,342561.25,28419,2417,26002,4
940,2020-03-10,서대문구,372220.3862,254336.6667,15024,1489,13535,0
941,2020-03-10,서초구,589209.9447,423975.8333,36555,2544,34011,0
942,2020-03-10,성동구,356019.0033,263893.75,17072,1334,15738,0
943,2020-03-10,성북구,434503.9083,337210.4167,17228,1584,15644,0
944,2020-03-10,송파구,771173.2809,523222.5,37450,3186,34264,1
945,2020-03-10,양천구,409004.1813,324727.5,18361,1655,16706,7
946,2020-03-10,영등포구,478861.291,409834.1667,27266,2258,25008,5
947,2020-03-10,용산구,289068.8892,214712.0833,19047,1178,17869,0
948,2020-03-10,은평구,451743.2406,329777.5,18313,1554,16759,2
949,2020-03-10,종로구,279804.9377,222492.0833,25500,1616,23884,0
950,2020-03-10,중구,274677.7648,237737.0833,40338,2095,38243,0
951,2020-03-10,중랑구,364770.7222,292748.75,16161,1275,14886,0
952,2020-03-11,강남구,855369.2145,489435.4167,55875,4371,51504,0
953,2020-03-11,강동구,511624.9458,264939.5833,20974,1901,19073,0
954,2020-03-11,강북구,308347.1792,186690,13417,1075,12342,0
955,2020-03-11,강서구,550738.3567,352537.9167,25902,2633,23269,3
956,2020-03-11,관악구,494229.8831,311114.5833,19734,1908,17826,0
957,2020-03-11,광진구,367199.8511,226130.8333,19004,1662,17342,0
958,2020-03-11,구로구,396986.535,284850.4167,22318,1785,20533,2
959,2020-03-11,금천구,235226.8147,186935.8333,15677,1274,14403,0
960,2020-03-11,노원구,530282.8282,310857.5,18188,1859,16329,0
961,2020-03-11,도봉구,282915.1388,190105,11691,992,10699,0
962,2020-03-11,동대문구,359276.2965,231748.3333,21212,1475,19737,3
963,2020-03-11,동작구,403590.4743,245261.6667,15894,1581,14313,0
964,2020-03-11,마포구,464515.7753,274136.6667,28419,2417,26002,1
965,2020-03-11,서대문구,370483.8018,202776.25,15024,1489,13535,2
966,2020-03-11,서초구,590274.0502,337392.9167,36555,2544,34011,0
967,2020-03-11,성동구,356018.0412,210311.6667,17072,1334,15738,0
968,2020-03-11,성북구,432230.3458,268321.6667,17228,1584,15644,2
969,2020-03-11,송파구,771076.8817,416246.6667,37450,3186,34264,1
970,2020-03-11,양천구,407352.4665,258329.1667,18361,1655,16706,0
971,2020-03-11,영등포구,477800.6551,325167.9167,27266,2258,25008,0
972,2020-03-11,용산구,290011.0624,171390.8333,19047,1178,17869,0
973,2020-03-11,은평구,449328.6699,262085.8333,18313,1554,16759,2
974,2020-03-11,종로구,283248.5555,177684.5833,25500,1616,23884,0
975,2020-03-11,중구,275655.6017,187962.0833,40338,2095,38243,0
976,2020-03-11,중랑구,362704.3659,232594.1667,16161,1275,14886,1
977,2020-03-12,강남구,854338.7506,616600,55875,4371,51504,1
978,2020-03-12,강동구,510774.6992,331123.3333,20974,1901,19073,0
979,2020-03-12,강북구,307396.484,232685,13417,1075,12342,1
980,2020-03-12,강서구,548953.8299,440487.0833,25902,2633,23269,0
981,2020-03-12,관악구,492893.6044,387510.8333,19734,1908,17826,1
982,2020-03-12,광진구,367107.7918,283215,19004,1662,17342,0
983,2020-03-12,구로구,394918.4105,354848.3333,22318,1785,20533,0
984,2020-03-12,금천구,234917.499,233970.4167,15677,1274,14403,2
985,2020-03-12,노원구,529832.5248,388228.3333,18188,1859,16329,1
986,2020-03-12,도봉구,282695.6891,236469.1667,11691,992,10699,0
987,2020-03-12,동대문구,358074.1318,288801.25,21212,1475,19737,1
988,2020-03-12,동작구,403905.9971,305787.0833,15894,1581,14313,0
989,2020-03-12,마포구,463517.9389,343347.5,28419,2417,26002,0
990,2020-03-12,서대문구,370089.1414,254020.8333,15024,1489,13535,0
991,2020-03-12,서초구,589302.3964,424214.5833,36555,2544,34011,1
992,2020-03-12,성동구,355719.3222,263365.4167,17072,1334,15738,0
993,2020-03-12,성북구,432341.889,335165,17228,1584,15644,1
994,2020-03-12,송파구,769116.5479,521017.5,37450,3186,34264,1
995,2020-03-12,양천구,407282.0938,322533.75,18361,1655,16706,0
996,2020-03-12,영등포구,475774.0829,407071.25,27266,2258,25008,0
997,2020-03-12,용산구,288935.3411,214372.5,19047,1178,17869,1
998,2020-03-12,은평구,447575.5046,326777.5,18313,1554,16759,0
999,2020-03-12,종로구,282313.6623,223668.75,25500,1616,23884,0
1000,2020-03-12,중구,275263.1248,238017.0833,40338,2095,38243,0
1001,2020-03-12,중랑구,361181.8351,289327.5,16161,1275,14886,1
1002,2020-03-13,강남구,850132.2852,615055.4167,55875,4371,51504,0
1003,2020-03-13,강동구,511690.0625,332002.0833,20974,1901,19073,0
1004,2020-03-13,강북구,308070.4694,233457.0833,13417,1075,12342,0
1005,2020-03-13,강서구,548146.9702,440073.3333,25902,2633,23269,0
1006,2020-03-13,관악구,492987.7146,388157.5,19734,1908,17826,1
1007,2020-03-13,광진구,367785.481,283951.25,19004,1662,17342,0
1008,2020-03-13,구로구,393129.5035,352808.3333,22318,1785,20533,0
1009,2020-03-13,금천구,232513.8793,231851.25,15677,1274,14403,0
1010,2020-03-13,노원구,529770.7985,388937.5,18188,1859,16329,1
1011,2020-03-13,도봉구,281965.2367,236454.1667,11691,992,10699,0
1012,2020-03-13,동대문구,357108.4661,288254.5833,21212,1475,19737,3
1013,2020-03-13,동작구,403411.809,306879.1667,15894,1581,14313,1
1014,2020-03-13,마포구,465439.4546,345458.75,28419,2417,26002,1
1015,2020-03-13,서대문구,368212.3377,253756.6667,15024,1489,13535,0
1016,2020-03-13,서초구,587258.5362,423393.3333,36555,2544,34011,2
1017,2020-03-13,성동구,355828.9136,262298.75,17072,1334,15738,0
1018,2020-03-13,성북구,431079.914,335032.9167,17228,1584,15644,0
1019,2020-03-13,송파구,767097.5486,520923.75,37450,3186,34264,0
1020,2020-03-13,양천구,407194.3835,322890.8333,18361,1655,16706,0
1021,2020-03-13,영등포구,472214.9426,404698.75,27266,2258,25008,0
1022,2020-03-13,용산구,288591.8241,214577.9167,19047,1178,17869,0
1023,2020-03-13,은평구,447839.7857,327485.8333,18313,1554,16759,0
1024,2020-03-13,종로구,278552.4057,219724.5833,25500,1616,23884,0
1025,2020-03-13,중구,270456.5732,232308.75,40338,2095,38243,0
1026,2020-03-13,중랑구,361407.5339,289984.1667,16161,1275,14886,0
1027,2020-03-14,강남구,723474.6375,497138.3333,55875,4371,51504,1
1028,2020-03-14,강동구,522330.4253,344611.25,20974,1901,19073,0
1029,2020-03-14,강북구,319360.9859,247183.75,13417,1075,12342,0
1030,2020-03-14,강서구,551795.408,447400,25902,2633,23269,0
1031,2020-03-14,관악구,515302.846,412615,19734,1908,17826,0
1032,2020-03-14,광진구,377685.4365,295739.1667,19004,1662,17342,0
1033,2020-03-14,구로구,384267.1609,346493.75,22318,1785,20533,2
1034,2020-03-14,금천구,208166.8729,202869.5833,15677,1274,14403,0
1035,2020-03-14,노원구,550423.6925,413810.8333,18188,1859,16329,0
1036,2020-03-14,도봉구,295038.1862,253310,11691,992,10699,1
1037,2020-03-14,동대문구,355146.1758,288536.6667,21212,1475,19737,0
1038,2020-03-14,동작구,409448.0856,315679.1667,15894,1581,14313,0
1039,2020-03-14,마포구,449760.9964,330409.5833,28419,2417,26002,1
1040,2020-03-14,서대문구,355860.3353,254167.9167,15024,1489,13535,0
1041,2020-03-14,서초구,520665.3971,359875.4167,36555,2544,34011,0
1042,2020-03-14,성동구,337817.2755,242913.75,17072,1334,15738,0
1043,2020-03-14,성북구,440932.0619,346257.9167,17228,1584,15644,0
1044,2020-03-14,송파구,755213.3014,512087.5,37450,3186,34264,0
1045,2020-03-14,양천구,420065.5918,339937.0833,18361,1655,16706,0
1046,2020-03-14,영등포구,420890.97,352717.9167,27266,2258,25008,2
1047,2020-03-14,용산구,273978.7552,201209.1667,19047,1178,17869,0
1048,2020-03-14,은평구,470102.0257,352214.5833,18313,1554,16759,0
1049,2020-03-14,종로구,232911.7005,167032.5,25500,1616,23884,0
1050,2020-03-14,중구,190704.882,145114.5833,40338,2095,38243,0
1051,2020-03-14,중랑구,375655.3205,307242.5,16161,1275,14886,1
1052,2020-03-15,강남구,680370.4413,458221.25,55875,4371,51504,0
1053,2020-03-15,강동구,527663.9427,347205.8333,20974,1901,19073,0
1054,2020-03-15,강북구,326421.7821,252641.6667,13417,1075,12342,0
1055,2020-03-15,강서구,557084.4071,449203.3333,25902,2633,23269,1
1056,2020-03-15,관악구,525857.9425,420129.5833,19734,1908,17826,0
1057,2020-03-15,광진구,378298.8089,297286.6667,19004,1662,17342,0
1058,2020-03-15,구로구,387830.685,350489.5833,22318,1785,20533,2
1059,2020-03-15,금천구,209202.806,203699.5833,15677,1274,14403,0
1060,2020-03-15,노원구,559759.1999,422506.25,18188,1859,16329,1
1061,2020-03-15,도봉구,301457.7095,260810,11691,992,10699,0
1062,2020-03-15,동대문구,355857.4892,289370.8333,21212,1475,19737,0
1063,2020-03-15,동작구,413548.0638,317789.5833,15894,1581,14313,0
1064,2020-03-15,마포구,438593.496,318881.25,28419,2417,26002,0
1065,2020-03-15,서대문구,356158.7456,254288.75,15024,1489,13535,0
1066,2020-03-15,서초구,500811.2366,340285,36555,2544,34011,0
1067,2020-03-15,성동구,334881.9271,238040,17072,1334,15738,0
1068,2020-03-15,성북구,448839.5739,352787.0833,17228,1584,15644,0
1069,2020-03-15,송파구,752250.2578,509308.75,37450,3186,34264,0
1070,2020-03-15,양천구,424953.8567,344982.5,18361,1655,16706,0
1071,2020-03-15,영등포구,412001.6154,344757.9167,27266,2258,25008,1
1072,2020-03-15,용산구,268299.0272,194785.8333,19047,1178,17869,0
1073,2020-03-15,은평구,481797.7127,361384.5833,18313,1554,16759,1
1074,2020-03-15,종로구,217299.8982,151904.5833,25500,1616,23884,0
1075,2020-03-15,중구,169257.406,126172.5,40338,2095,38243,0
1076,2020-03-15,중랑구,382997.3477,314256.6667,16161,1275,14886,0
1077,2020-03-16,강남구,846197.0125,613019.1667,55875,4371,51504,0
1078,2020-03-16,강동구,512171.458,330537.0833,20974,1901,19073,0
1079,2020-03-16,강북구,308072.3421,233493.75,13417,1075,12342,0
1080,2020-03-16,강서구,549848.0456,440124.1667,25902,2633,23269,1
1081,2020-03-16,관악구,494550.4256,387477.5,19734,1908,17826,2
1082,2020-03-16,광진구,366615.869,282832.0833,19004,1662,17342,0
1083,2020-03-16,구로구,395765.0561,355723.75,22318,1785,20533,2
1084,2020-03-16,금천구,235502.7132,236023.75,15677,1274,14403,0
1085,2020-03-16,노원구,532474.4819,389623.3333,18188,1859,16329,0
1086,2020-03-16,도봉구,283001.5326,237269.5833,11691,992,10699,0
1087,2020-03-16,동대문구,360728.4182,291741.6667,21212,1475,19737,2
1088,2020-03-16,동작구,405943.0355,308069.1667,15894,1581,14313,1
1089,2020-03-16,마포구,460935.6763,341535.8333,28419,2417,26002,0
1090,2020-03-16,서대문구,372272.7872,254826.6667,15024,1489,13535,2
1091,2020-03-16,서초구,588285.394,423293.3333,36555,2544,34011,0
1092,2020-03-16,성동구,357142.614,263250,17072,1334,15738,0
1093,2020-03-16,성북구,434049.3183,335506.25,17228,1584,15644,0
1094,2020-03-16,송파구,767494.3806,520035.4167,37450,3186,34264,0
1095,2020-03-16,양천구,407733.7905,321311.6667,18361,1655,16706,0
1096,2020-03-16,영등포구,474114.1243,407277.5,27266,2258,25008,1
1097,2020-03-16,용산구,288124.8022,212790.8333,19047,1178,17869,1
1098,2020-03-16,은평구,450271.1593,327734.5833,18313,1554,16759,1
1099,2020-03-16,종로구,279552.0234,221104.1667,25500,1616,23884,0
1100,2020-03-16,중구,270636.4127,236182.9167,40338,2095,38243,0
1101,2020-03-16,중랑구,362488.793,290431.25,16161,1275,14886,0
1102,2020-03-17,강남구,854828.3731,617640.8333,55875,4371,51504,0
1103,2020-03-17,강동구,511497.5593,330949.1667,20974,1901,19073,0
1104,2020-03-17,강북구,306911.28,232400.8333,13417,1075,12342,0
1105,2020-03-17,강서구,548162.6589,439179.5833,25902,2633,23269,0
1106,2020-03-17,관악구,493739.765,386812.9167,19734,1908,17826,0
1107,2020-03-17,광진구,366089.5018,282355,19004,1662,17342,0
1108,2020-03-17,구로구,393361.179,353594.1667,22318,1785,20533,0
1109,2020-03-17,금천구,235243.1675,235350,15677,1274,14403,0
1110,2020-03-17,노원구,531508.3925,388732.5,18188,1859,16329,0
1111,2020-03-17,도봉구,281622.2424,236018.75,11691,992,10699,0
1112,2020-03-17,동대문구,359551.944,290867.5,21212,1475,19737,1
1113,2020-03-17,동작구,406311.1206,308286.6667,15894,1581,14313,0
1114,2020-03-17,마포구,463465.4107,342267.0833,28419,2417,26002,1
1115,2020-03-17,서대문구,373369,255375.4167,15024,1489,13535,0
1116,2020-03-17,서초구,592234.6194,424537.5,36555,2544,34011,0
1117,2020-03-17,성동구,358084.2511,263337.0833,17072,1334,15738,0
1118,2020-03-17,성북구,434351.5293,335572.0833,17228,1584,15644,0
1119,2020-03-17,송파구,768295.4996,520440.4167,37450,3186,34264,1
1120,2020-03-17,양천구,408020.9482,321592.0833,18361,1655,16706,0
1121,2020-03-17,영등포구,476378.0988,407678.3333,27266,2258,25008,0
1122,2020-03-17,용산구,289160.8227,212982.0833,19047,1178,17869,0
1123,2020-03-17,은평구,448411.9983,326717.5,18313,1554,16759,0
1124,2020-03-17,종로구,282552.0085,222830.4167,25500,1616,23884,0
1125,2020-03-17,중구,275940.0366,238164.5833,40338,2095,38243,0
1126,2020-03-17,중랑구,361261.333,288796.6667,16161,1275,14886,1
1127,2020-03-18,강남구,855021.7806,616964.5833,55875,4371,51504,2
1128,2020-03-18,강동구,510483.4123,329902.5,20974,1901,19073,0
1129,2020-03-18,강북구,305920.808,231587.5,13417,1075,12342,0
1130,2020-03-18,강서구,546564.143,437535,25902,2633,23269,0
1131,2020-03-18,관악구,492747.4197,385496.25,19734,1908,17826,0
1132,2020-03-18,광진구,366192.9163,282412.5,19004,1662,17342,1
1133,2020-03-18,구로구,392689.8649,352159.1667,22318,1785,20533,0
1134,2020-03-18,금천구,233847.6779,234661.6667,15677,1274,14403,0
1135,2020-03-18,노원구,529960.7778,386623.3333,18188,1859,16329,1
1136,2020-03-18,도봉구,281524.8432,235255.8333,11691,992,10699,0
1137,2020-03-18,동대문구,359352.9927,290203.3333,21212,1475,19737,0
1138,2020-03-18,동작구,405319.8533,307427.9167,15894,1581,14313,2
1139,2020-03-18,마포구,464476.215,342858.75,28419,2417,26002,1
1140,2020-03-18,서대문구,371849.1829,254712.5,15024,1489,13535,0
1141,2020-03-18,서초구,591678.2479,424608.3333,36555,2544,34011,0
1142,2020-03-18,성동구,357315.4759,262972.5,17072,1334,15738,0
1143,2020-03-18,성북구,433218.7194,334237.0833,17228,1584,15644,2
1144,2020-03-18,송파구,767125.1929,519435,37450,3186,34264,0
1145,2020-03-18,양천구,407134.7683,320402.9167,18361,1655,16706,1
1146,2020-03-18,영등포구,476379.0795,407021.25,27266,2258,25008,0
1147,2020-03-18,용산구,289982.9134,213819.1667,19047,1178,17869,1
1148,2020-03-18,은평구,446200.7327,325202.0833,18313,1554,16759,0
1149,2020-03-18,종로구,285331.1354,225065.4167,25500,1616,23884,0
1150,2020-03-18,중구,276056.992,238146.25,40338,2095,38243,0
1151,2020-03-18,중랑구,359892.0894,287481.25,16161,1275,14886,0
1152,2020-03-19,강남구,853726.8019,615865.4167,55875,4371,51504,1
1153,2020-03-19,강동구,513127.231,330630.8333,20974,1901,19073,0
1154,2020-03-19,강북구,307156.0325,232729.5833,13417,1075,12342,0
1155,2020-03-19,강서구,548063.3631,438525,25902,2633,23269,1
1156,2020-03-19,관악구,493802.3473,386358.3333,19734,1908,17826,1
1157,2020-03-19,광진구,365720.5067,282791.25,19004,1662,17342,0
1158,2020-03-19,구로구,394674.0889,353822.0833,22318,1785,20533,0
1159,2020-03-19,금천구,234713.3411,235157.5,15677,1274,14403,0
1160,2020-03-19,노원구,531925.4675,388510.4167,18188,1859,16329,2
1161,2020-03-19,도봉구,281919.6902,236445.4167,11691,992,10699,0
1162,2020-03-19,동대문구,360152.2697,290847.9167,21212,1475,19737,0
1163,2020-03-19,동작구,406816.1947,308174.5833,15894,1581,14313,2
1164,2020-03-19,마포구,463558.1756,341530.4167,28419,2417,26002,3
1165,2020-03-19,서대문구,373677.0735,255465,15024,1489,13535,0
1166,2020-03-19,서초구,589587.2861,422477.9167,36555,2544,34011,0
1167,2020-03-19,성동구,357683.1941,263308.75,17072,1334,15738,1
1168,2020-03-19,성북구,435096.9459,335828.75,17228,1584,15644,0
1169,2020-03-19,송파구,767644.5483,520327.5,37450,3186,34264,2
1170,2020-03-19,양천구,408386.6217,321846.6667,18361,1655,16706,1
1171,2020-03-19,영등포구,474286.5737,406223.75,27266,2258,25008,2
1172,2020-03-19,용산구,288815.8776,213210.4167,19047,1178,17869,1
1173,2020-03-19,은평구,448606.1884,327112.0833,18313,1554,16759,0
1174,2020-03-19,종로구,281161.5286,221851.6667,25500,1616,23884,0
1175,2020-03-19,중구,273821.0486,236426.25,40338,2095,38243,0
1176,2020-03-19,중랑구,361382.5366,288870.4167,16161,1275,14886,0
1177,2020-03-20,강남구,851396.9949,615048.75,55875,4371,51504,0
1178,2020-03-20,강동구,512147.4814,330459.5833,20974,1901,19073,2
1179,2020-03-20,강북구,306404.4475,232245.4167,13417,1075,12342,0
1180,2020-03-20,강서구,544801.2514,436580.4167,25902,2633,23269,1
1181,2020-03-20,관악구,491902.8937,384766.6667,19734,1908,17826,1
1182,2020-03-20,광진구,368285.3392,284674.1667,19004,1662,17342,1
1183,2020-03-20,구로구,392112.4395,351391.6667,22318,1785,20533,1
1184,2020-03-20,금천구,232641.8662,232898.3333,15677,1274,14403,0
1185,2020-03-20,노원구,530499.8381,387103.3333,18188,1859,16329,2
1186,2020-03-20,도봉구,281212.1776,234989.1667,11691,992,10699,0
1187,2020-03-20,동대문구,358085.3616,288494.5833,21212,1475,19737,0
1188,2020-03-20,동작구,405938.8169,307545.8333,15894,1581,14313,2
1189,2020-03-20,마포구,468036.2858,345547.0833,28419,2417,26002,0
1190,2020-03-20,서대문구,370749.0076,253985.4167,15024,1489,13535,0
1191,2020-03-20,서초구,592500.9983,424172.5,36555,2544,34011,2
1192,2020-03-20,성동구,356896.5243,262398.3333,17072,1334,15738,1
1193,2020-03-20,성북구,432513.6373,333380.8333,17228,1584,15644,1
1194,2020-03-20,송파구,766564.0723,518442.0833,37450,3186,34264,0
1195,2020-03-20,양천구,407713.2931,320591.6667,18361,1655,16706,0
1196,2020-03-20,영등포구,473801.7413,404369.1667,27266,2258,25008,1
1197,2020-03-20,용산구,291658.4717,215232.9167,19047,1178,17869,0
1198,2020-03-20,은평구,446262.3057,324894.1667,18313,1554,16759,1
1199,2020-03-20,종로구,282581.5693,221829.1667,25500,1616,23884,0
1200,2020-03-20,중구,273051.2388,233613.3333,40338,2095,38243,0
1201,2020-03-20,중랑구,360249.0577,287180.4167,16161,1275,14886,1
1202,2020-03-21,강남구,722221.5754,487870.8333,55875,4371,51504,0
1203,2020-03-21,강동구,523453.4721,340042.9167,20974,1901,19073,0
1204,2020-03-21,강북구,318125.104,241459.1667,13417,1075,12342,0
1205,2020-03-21,강서구,547500.881,437730.8333,25902,2633,23269,1
1206,2020-03-21,관악구,515004.9085,403625,19734,1908,17826,0
1207,2020-03-21,광진구,377323.6197,291694.1667,19004,1662,17342,0
1208,2020-03-21,구로구,382164.0445,337660.8333,22318,1785,20533,0
1209,2020-03-21,금천구,209372.8123,200930.4167,15677,1274,14403,0
1210,2020-03-21,노원구,548611.2622,402974.1667,18188,1859,16329,0
1211,2020-03-21,도봉구,293431.8923,247460.4167,11691,992,10699,0
1212,2020-03-21,동대문구,354784.9924,282433.75,21212,1475,19737,0
1213,2020-03-21,동작구,410878.198,309399.1667,15894,1581,14313,0
1214,2020-03-21,마포구,453271.7494,326513.3333,28419,2417,26002,0
1215,2020-03-21,서대문구,356118.5928,248090.4167,15024,1489,13535,2
1216,2020-03-21,서초구,526588.0634,354958.3333,36555,2544,34011,1
1217,2020-03-21,성동구,338143.6131,238688.75,17072,1334,15738,1
1218,2020-03-21,성북구,439934.2939,338565,17228,1584,15644,0
1219,2020-03-21,송파구,754732.2878,502730.4167,37450,3186,34264,0
1220,2020-03-21,양천구,418539.7003,333367.0833,18361,1655,16706,0
1221,2020-03-21,영등포구,423522.1742,350707.5,27266,2258,25008,1
1222,2020-03-21,용산구,275353.8143,198167.0833,19047,1178,17869,0
1223,2020-03-21,은평구,468077.6786,344351.6667,18313,1554,16759,0
1224,2020-03-21,종로구,235392.5027,166923.75,25500,1616,23884,0
1225,2020-03-21,중구,193229.8359,142887.0833,40338,2095,38243,0
1226,2020-03-21,중랑구,374637.6905,299984.1667,16161,1275,14886,2
1227,2020-03-22,강남구,675940.7763,454995.8333,55875,4371,51504,0
1228,2020-03-22,강동구,524610.1746,343020,20974,1901,19073,0
1229,2020-03-22,강북구,323973.6144,250844.1667,13417,1075,12342,0
1230,2020-03-22,강서구,550251.3606,443557.0833,25902,2633,23269,1
1231,2020-03-22,관악구,521573.0325,414904.5833,19734,1908,17826,0
1232,2020-03-22,광진구,378238.4832,296459.5833,19004,1662,17342,0
1233,2020-03-22,구로구,384442.0225,346182.0833,22318,1785,20533,0
1234,2020-03-22,금천구,207771.7815,202552.5,15677,1274,14403,0
1235,2020-03-22,노원구,554230.7981,416355,18188,1859,16329,0
1236,2020-03-22,도봉구,299193.0568,258699.1667,11691,992,10699,1
1237,2020-03-22,동대문구,352922.0869,286541.6667,21212,1475,19737,0
1238,2020-03-22,동작구,412238.0105,314526.6667,15894,1581,14313,0
1239,2020-03-22,마포구,441504.7065,320152.5,28419,2417,26002,0
1240,2020-03-22,서대문구,354382.622,252155,15024,1489,13535,2
1241,2020-03-22,서초구,501719.8473,339050.4167,36555,2544,34011,0
1242,2020-03-22,성동구,332548.3538,236423.3333,17072,1334,15738,0
1243,2020-03-22,성북구,444801.2195,348483.3333,17228,1584,15644,1
1244,2020-03-22,송파구,749242.5506,503708.75,37450,3186,34264,0
1245,2020-03-22,양천구,421681.0842,341458.75,18361,1655,16706,0
1246,2020-03-22,영등포구,414763.7961,344740.8333,27266,2258,25008,0
1247,2020-03-22,용산구,269384.6406,194542.9167,19047,1178,17869,0
1248,2020-03-22,은평구,476251.3162,356779.5833,18313,1554,16759,1
1249,2020-03-22,종로구,220249.7626,153700,25500,1616,23884,0
1250,2020-03-22,중구,170672.2484,124896.6667,40338,2095,38243,0
1251,2020-03-22,중랑구,380084.8729,308445.4167,16161,1275,14886,0
1252,2020-03-23,강남구,850409.8805,613717.0833,55875,4371,51504,1
1253,2020-03-23,강동구,512583.0442,330227.0833,20974,1901,19073,0
1254,2020-03-23,강북구,307579.3066,231977.9167,13417,1075,12342,0
1255,2020-03-23,강서구,546477.6827,436926.6667,25902,2633,23269,0
1256,2020-03-23,관악구,492362.2626,384950.4167,19734,1908,17826,0
1257,2020-03-23,광진구,366650.2447,281896.6667,19004,1662,17342,0
1258,2020-03-23,구로구,394325.5508,353780.8333,22318,1785,20533,0
1259,2020-03-23,금천구,236434.2497,237857.5,15677,1274,14403,0
1260,2020-03-23,노원구,530266.5907,387330,18188,1859,16329,0
1261,2020-03-23,도봉구,281775.5013,235098.75,11691,992,10699,0
1262,2020-03-23,동대문구,359145.9617,290952.0833,21212,1475,19737,0
1263,2020-03-23,동작구,406661.6374,306655,15894,1581,14313,0
1264,2020-03-23,마포구,463474.5001,341840,28419,2417,26002,0
1265,2020-03-23,서대문구,371227.592,253712.5,15024,1489,13535,0
1266,2020-03-23,서초구,592826.2869,423989.1667,36555,2544,34011,0
1267,2020-03-23,성동구,356599.9746,261333.75,17072,1334,15738,0
1268,2020-03-23,성북구,432261.5674,334554.1667,17228,1584,15644,0
1269,2020-03-23,송파구,765000.3197,517321.6667,37450,3186,34264,1
1270,2020-03-23,양천구,407087.2757,320235.8333,18361,1655,16706,0
1271,2020-03-23,영등포구,477301.4896,408197.9167,27266,2258,25008,1
1272,2020-03-23,용산구,287750.0916,212220.8333,19047,1178,17869,1
1273,2020-03-23,은평구,448327.0306,326436.6667,18313,1554,16759,0
1274,2020-03-23,종로구,281549.0282,221082.0833,25500,1616,23884,1
1275,2020-03-23,중구,272075.6958,236943.3333,40338,2095,38243,0
1276,2020-03-23,중랑구,361172.316,288490.4167,16161,1275,14886,0
1277,2020-03-24,강남구,856550.2412,616286.25,55875,4371,51504,1
1278,2020-03-24,강동구,510362.8323,329032.5,20974,1901,19073,1
1279,2020-03-24,강북구,306670.1694,231017.5,13417,1075,12342,0
1280,2020-03-24,강서구,545417.1575,435508.3333,25902,2633,23269,2
1281,2020-03-24,관악구,491169.3255,384474.1667,19734,1908,17826,0
1282,2020-03-24,광진구,365543.8253,280734.5833,19004,1662,17342,0
1283,2020-03-24,구로구,391086.5736,351070,22318,1785,20533,0
1284,2020-03-24,금천구,235240.473,235826.25,15677,1274,14403,0
1285,2020-03-24,노원구,529127.5046,386472.0833,18188,1859,16329,0
1286,2020-03-24,도봉구,280482.0064,233662.9167,11691,992,10699,1
1287,2020-03-24,동대문구,359573.7621,290337.0833,21212,1475,19737,1
1288,2020-03-24,동작구,406455.5043,306647.9167,15894,1581,14313,1
1289,2020-03-24,마포구,465157.8255,342282.0833,28419,2417,26002,0
1290,2020-03-24,서대문구,370446.1046,253897.0833,15024,1489,13535,0
1291,2020-03-24,서초구,597756.9274,424905.8333,36555,2544,34011,1
1292,2020-03-24,성동구,357497.6764,262068.3333,17072,1334,15738,0
1293,2020-03-24,성북구,431951.5985,333500,17228,1584,15644,0
1294,2020-03-24,송파구,764680.2677,517370.8333,37450,3186,34264,0
1295,2020-03-24,양천구,406993.1199,319466.6667,18361,1655,16706,0
1296,2020-03-24,영등포구,478094.1659,407604.1667,27266,2258,25008,0
1297,2020-03-24,용산구,289435.1539,213188.75,19047,1178,17869,1
1298,2020-03-24,은평구,447220.2442,324211.25,18313,1554,16759,1
1299,2020-03-24,종로구,286597.6087,224332.5,25500,1616,23884,1
1300,2020-03-24,중구,276589.5457,237945.4167,40338,2095,38243,0
1301,2020-03-24,중랑구,359393.5208,286448.3333,16161,1275,14886,2
1302,2020-03-24,중랑구,359393.5208,286448.3333,16161,1275,14886,1
1303,2020-03-25,강남구,855353.1181,616283.75,55875,4371,51504,4
1304,2020-03-25,강동구,509821.5029,328753.3333,20974,1901,19073,0
1305,2020-03-25,강북구,305565.0344,230404.1667,13417,1075,12342,0
1306,2020-03-25,강서구,544696.7432,435462.9167,25902,2633,23269,1
1307,2020-03-25,관악구,489809.9385,384372.0833,19734,1908,17826,0
1308,2020-03-25,광진구,366993.24,281768.75,19004,1662,17342,0
1309,2020-03-25,구로구,393638.2594,351250,22318,1785,20533,0
1310,2020-03-25,금천구,234913.9607,235017.9167,15677,1274,14403,1
1311,2020-03-25,노원구,527913.3474,386469.5833,18188,1859,16329,0
1312,2020-03-25,도봉구,279584.0509,232966.25,11691,992,10699,0
1313,2020-03-25,동대문구,359585.3743,290367.5,21212,1475,19737,0
1314,2020-03-25,동작구,405744.5869,306544.1667,15894,1581,14313,2
1315,2020-03-25,마포구,465679.1544,343739.5833,28419,2417,26002,0
1316,2020-03-25,서대문구,368132.0048,253740,15024,1489,13535,0
1317,2020-03-25,서초구,594975.6011,424564.1667,36555,2544,34011,3
1318,2020-03-25,성동구,358125.4863,262410.4167,17072,1334,15738,0
1319,2020-03-25,성북구,430741.7146,333453.3333,17228,1584,15644,0
1320,2020-03-25,송파구,764674.7818,518411.6667,37450,3186,34264,0
1321,2020-03-25,양천구,405146.7925,319122.0833,18361,1655,16706,0
1322,2020-03-25,영등포구,476002.5227,407868.3333,27266,2258,25008,0
1323,2020-03-25,용산구,290937.0971,214076.25,19047,1178,17869,0
1324,2020-03-25,은평구,445372.2619,323906.6667,18313,1554,16759,0
1325,2020-03-25,종로구,286199.5183,224908.3333,25500,1616,23884,0
1326,2020-03-25,중구,274449.6726,236991.6667,40338,2095,38243,0
1327,2020-03-25,중랑구,357755.6192,285932.9167,16161,1275,14886,2
1328,2020-03-26,강남구,858010.7331,616257.9167,55875,4371,51504,4
1329,2020-03-26,강동구,510602.6677,329281.25,20974,1901,19073,1
1330,2020-03-26,강북구,306115.5233,231185,13417,1075,12342,0
1331,2020-03-26,강서구,545140.3774,435687.5,25902,2633,23269,0
1332,2020-03-26,관악구,491289.7638,384585.8333,19734,1908,17826,0
1333,2020-03-26,광진구,366111.0167,281241.25,19004,1662,17342,0
1334,2020-03-26,구로구,394473.9113,352295.8333,22318,1785,20533,2
1335,2020-03-26,금천구,235300.5449,235181.25,15677,1274,14403,1
1336,2020-03-26,노원구,529997.2477,386812.9167,18188,1859,16329,0
1337,2020-03-26,도봉구,280800.0225,234131.6667,11691,992,10699,0
1338,2020-03-26,동대문구,360826.4294,290641.25,21212,1475,19737,0
1339,2020-03-26,동작구,406328.2564,306950,15894,1581,14313,0
1340,2020-03-26,마포구,464875.6923,342548.75,28419,2417,26002,0
1341,2020-03-26,서대문구,369870.1911,254482.0833,15024,1489,13535,0
1342,2020-03-26,서초구,596143.3342,423591.6667,36555,2544,34011,1
1343,2020-03-26,성동구,358559.9015,262079.5833,17072,1334,15738,0
1344,2020-03-26,성북구,432521.7892,334277.9167,17228,1584,15644,1
1345,2020-03-26,송파구,766107.8358,518344.1667,37450,3186,34264,2
1346,2020-03-26,양천구,406890.4937,319745,18361,1655,16706,0
1347,2020-03-26,영등포구,474731.0362,405995.4167,27266,2258,25008,0
1348,2020-03-26,용산구,291709.6829,213351.25,19047,1178,17869,1
1349,2020-03-26,은평구,447518.6798,325952.9167,18313,1554,16759,0
1350,2020-03-26,종로구,284808.4783,223313.3333,25500,1616,23884,0
1351,2020-03-26,중구,274327.4289,236280,40338,2095,38243,0
1352,2020-03-26,중랑구,359159.4196,287305.4167,16161,1275,14886,1
1353,2020-03-27,강남구,855765.3524,614022.9167,55875,4371,51504,2
1354,2020-03-27,강동구,511236.7546,329881.6667,20974,1901,19073,0
1355,2020-03-27,강북구,307248.5891,231423.75,13417,1075,12342,0
1356,2020-03-27,강서구,543479.0335,434737.5,25902,2633,23269,0
1357,2020-03-27,관악구,491495.9599,384534.1667,19734,1908,17826,1
1358,2020-03-27,광진구,368985.4351,282990.8333,19004,1662,17342,0
1359,2020-03-27,구로구,394939.749,352174.5833,22318,1785,20533,1
1360,2020-03-27,금천구,233838.0342,233589.5833,15677,1274,14403,1
1361,2020-03-27,노원구,530888.8053,387328.3333,18188,1859,16329,0
1362,2020-03-27,도봉구,280131.2152,233512.0833,11691,992,10699,1
1363,2020-03-27,동대문구,359834.2537,290033.75,21212,1475,19737,0
1364,2020-03-27,동작구,407694.2347,307117.9167,15894,1581,14313,0
1365,2020-03-27,마포구,469150.2357,344630,28419,2417,26002,1
1366,2020-03-27,서대문구,367432.4438,253327.5,15024,1489,13535,0
1367,2020-03-27,서초구,596150.5461,423505.4167,36555,2544,34011,1
1368,2020-03-27,성동구,357849.8532,261608.3333,17072,1334,15738,0
1369,2020-03-27,성북구,431836.0805,333388.3333,17228,1584,15644,1
1370,2020-03-27,송파구,767803.8274,518502.9167,37450,3186,34264,1
1371,2020-03-27,양천구,407326.0277,319875.4167,18361,1655,16706,0
1372,2020-03-27,영등포구,475525.6494,405566.25,27266,2258,25008,1
1373,2020-03-27,용산구,293021.5918,214251.6667,19047,1178,17869,0
1374,2020-03-27,은평구,448587.2567,325356.25,18313,1554,16759,0
1375,2020-03-27,종로구,282978.8231,220643.3333,25500,1616,23884,0
1376,2020-03-27,중구,272236.9152,232349.1667,40338,2095,38243,1
1377,2020-03-27,중랑구,360063.8198,287002.9167,16161,1275,14886,2
1378,2020-03-27,중랑구,360063.8198,287002.9167,16161,1275,14886,1
1379,2020-03-28,강남구,720906.3227,490211.6667,55875,4371,51504,5
1380,2020-03-28,강동구,520522.0426,341008.75,20974,1901,19073,0
1381,2020-03-28,강북구,318205.0705,243836.25,13417,1075,12342,0
1382,2020-03-28,강서구,546591.7664,440383.3333,25902,2633,23269,0
1383,2020-03-28,관악구,512957.0338,406251.6667,19734,1908,17826,1
1384,2020-03-28,광진구,378094.1107,293140.8333,19004,1662,17342,0
1385,2020-03-28,구로구,382980.182,341354.1667,22318,1785,20533,4
1386,2020-03-28,금천구,208586.6955,202842.5,15677,1274,14403,1
1387,2020-03-28,금천구,208586.6955,202842.5,15677,1274,14403,1
1388,2020-03-28,노원구,549665.5907,409982.9167,18188,1859,16329,0
1389,2020-03-28,도봉구,291901.6407,248745.8333,11691,992,10699,0
1390,2020-03-28,동대문구,355434.36,287579.1667,21212,1475,19737,0
1391,2020-03-28,동작구,413045.6877,314671.6667,15894,1581,14313,3
1392,2020-03-28,마포구,451941.8048,329193.3333,28419,2417,26002,0
1393,2020-03-28,서대문구,352887.5364,252047.5,15024,1489,13535,0
1394,2020-03-28,서초구,526999.9771,358394.5833,36555,2544,34011,4
1395,2020-03-28,성동구,338885.003,242232.9167,17072,1334,15738,0
1396,2020-03-28,성북구,439312.1815,342736.25,17228,1584,15644,0
1397,2020-03-28,송파구,755947.8282,507214.5833,37450,3186,34264,1
1398,2020-03-28,양천구,418718.7597,335845,18361,1655,16706,1
1399,2020-03-28,영등포구,424574.3612,352671.6667,27266,2258,25008,0
1400,2020-03-28,용산구,276918.2793,198681.25,19047,1178,17869,0
1401,2020-03-28,은평구,469775.034,347974.5833,18313,1554,16759,0
1402,2020-03-28,종로구,235799.4459,168576.6667,25500,1616,23884,0
1403,2020-03-28,중구,192968.1048,144531.6667,40338,2095,38243,1
1404,2020-03-28,중랑구,373859.6576,301955,16161,1275,14886,0
1405,2020-03-29,강남구,674480.5382,451665.8333,55875,4371,51504,4
1406,2020-03-29,강동구,523072.8722,341911.25,20974,1901,19073,0
1407,2020-03-29,강북구,323141.6565,248494.1667,13417,1075,12342,0
1408,2020-03-29,강서구,549322.6897,441447.5,25902,2633,23269,0
1409,2020-03-29,관악구,520548.6996,413444.1667,19734,1908,17826,3
1410,2020-03-29,광진구,377945.0883,294041.6667,19004,1662,17342,1
1411,2020-03-29,구로구,385900.8574,345261.6667,22318,1785,20533,1
1412,2020-03-29,금천구,208798.8069,202672.5,15677,1274,14403,4
1413,2020-03-29,노원구,555385.5129,416191.25,18188,1859,16329,0
1414,2020-03-29,도봉구,298352.9207,256363.75,11691,992,10699,1
1415,2020-03-29,동대문구,354623.8517,286780.4167,21212,1475,19737,0
1416,2020-03-29,동작구,413568.7806,314041.6667,15894,1581,14313,2
1417,2020-03-29,마포구,440123.794,318185,28419,2417,26002,1
1418,2020-03-29,서대문구,351128.4211,250943.75,15024,1489,13535,1
1419,2020-03-29,서초구,502961.5904,338520.4167,36555,2544,34011,0
1420,2020-03-29,성동구,333921.396,236813.3333,17072,1334,15738,0
1421,2020-03-29,성북구,444938.8081,347360.4167,17228,1584,15644,0
1422,2020-03-29,송파구,748879.0848,502924.1667,37450,3186,34264,1
1423,2020-03-29,양천구,420868.3168,340293.75,18361,1655,16706,0
1424,2020-03-29,영등포구,418210.1373,345990,27266,2258,25008,0
1425,2020-03-29,용산구,270088.3277,192959.5833,19047,1178,17869,1
1426,2020-03-29,은평구,477140.3148,355977.0833,18313,1554,16759,0
1427,2020-03-29,종로구,220597.8746,153025,25500,1616,23884,0
1428,2020-03-29,중구,171334.9104,125302.5,40338,2095,38243,0
1429,2020-03-29,중랑구,380105.9426,307113.3333,16161,1275,14886,2
1430,2020-03-30,강남구,849906.166,610069.1667,55875,4371,51504,1
1431,2020-03-30,강동구,511859.6666,328863.75,20974,1901,19073,1
1432,2020-03-30,강북구,306851.3225,231116.6667,13417,1075,12342,0
1433,2020-03-30,강서구,545721.6966,434754.1667,25902,2633,23269,0
1434,2020-03-30,관악구,491803.2352,383504.5833,19734,1908,17826,4
1435,2020-03-30,광진구,367260.0983,280416.6667,19004,1662,17342,0
1436,2020-03-30,구로구,396883.5084,353581.6667,22318,1785,20533,2
1437,2020-03-30,금천구,237492.2179,236977.9167,15677,1274,14403,0
1438,2020-03-30,노원구,530145.8624,386317.9167,18188,1859,16329,0
1439,2020-03-30,도봉구,281249.0813,233907.0833,11691,992,10699,0
1440,2020-03-30,동대문구,361331.3677,290322.0833,21212,1475,19737,0
1441,2020-03-30,동작구,406869.121,306292.0833,15894,1581,14313,2
1442,2020-03-30,마포구,462479.3298,340352.5,28419,2417,26002,0
1443,2020-03-30,서대문구,369537.8396,253425.8333,15024,1489,13535,0
1444,2020-03-30,서초구,592552.3936,424907.0833,36555,2544,34011,2
1445,2020-03-30,성동구,357586.8775,262117.5,17072,1334,15738,0
1446,2020-03-30,성북구,432970.5052,333392.0833,17228,1584,15644,0
1447,2020-03-30,송파구,765935.4057,515831.25,37450,3186,34264,1
1448,2020-03-30,양천구,406875.977,319536.25,18361,1655,16706,0
1449,2020-03-30,영등포구,477198.9339,407659.1667,27266,2258,25008,0
1450,2020-03-30,용산구,290292.9413,212175,19047,1178,17869,3
1451,2020-03-30,은평구,449137.4028,324990.8333,18313,1554,16759,0
1452,2020-03-30,종로구,282474.9531,221034.5833,25500,1616,23884,0
1453,2020-03-30,중구,272964.904,235531.6667,40338,2095,38243,1
1454,2020-03-30,중랑구,361452.0704,286765,16161,1275,14886,2
1455,2020-03-31,강남구,861077.9844,627700,55875,4371,51504,4
1456,2020-03-31,강동구,509650.7437,330051.6667,20974,1901,19073,0
1457,2020-03-31,강북구,305218.0702,234370,13417,1075,12342,0
1458,2020-03-31,강서구,545614.9183,440256.25,25902,2633,23269,0
1459,2020-03-31,관악구,490992.2383,390844.5833,19734,1908,17826,6
1460,2020-03-31,광진구,366905.5832,283660,19004,1662,17342,1
1461,2020-03-31,구로구,394835.1055,357120.8333,22318,1785,20533,1
1462,2020-03-31,금천구,237512.191,239347.5,15677,1274,14403,0
1463,2020-03-31,노원구,528938.1687,392286.25,18188,1859,16329,0
1464,2020-03-31,도봉구,280082.5665,235565.8333,11691,992,10699,0
1465,2020-03-31,동대문구,360967.6931,294797.9167,21212,1475,19737,0
1466,2020-03-31,동작구,406645.3202,312915,15894,1581,14313,1
1467,2020-03-31,마포구,465401.0425,348861.25,28419,2417,26002,2
1468,2020-03-31,서대문구,370608.918,256658.75,15024,1489,13535,0
1469,2020-03-31,서초구,597908.6179,433622.5,36555,2544,34011,1
1470,2020-03-31,성동구,358537.5427,267067.5,17072,1334,15738,0
1471,2020-03-31,성북구,432051.2135,338089.1667,17228,1584,15644,0
1472,2020-03-31,송파구,767186.096,525282.0833,37450,3186,34264,2
1473,2020-03-31,양천구,406595.9434,324695,18361,1655,16706,1
1474,2020-03-31,영등포구,479694.5105,413622.9167,27266,2258,25008,1
1475,2020-03-31,용산구,291791.4228,216917.5,19047,1178,17869,0
1476,2020-03-31,은평구,446864.2255,329425.8333,18313,1554,16759,0
1477,2020-03-31,종로구,286753.7358,229098.75,25500,1616,23884,1
1478,2020-03-31,중구,278245.8749,244405.4167,40338,2095,38243,1
1479,2020-03-31,중랑구,359266.475,289410.8333,16161,1275,14886,2
1480,2020-04-01,강남구,857667.5781,622667.5,55675,4353,51322,0
1481,2020-04-01,강동구,509360.5738,330602.0833,20935,1897,19038,0
1482,2020-04-01,강북구,305937.9651,234367.5,13461,1066,12395,0
1483,2020-04-01,강서구,545836.6206,440487.5,26009,2632,23377,0
1484,2020-04-01,관악구,491429.4959,391737.5,19710,1903,17807,0
1485,2020-04-01,광진구,370825.6241,284036.6667,18984,1668,17316,1
1486,2020-04-01,구로구,394731.4863,356886.25,22249,1798,20451,4
1487,2020-04-01,금천구,237369.6031,238115,15627,1271,14356,0
1488,2020-04-01,노원구,529005.0398,392995,18235,1866,16369,0
1489,2020-04-01,도봉구,280257.3798,236102.9167,11723,983,10740,0
1490,2020-04-01,동대문구,360755.1161,294389.5833,21157,1473,19684,1
1491,2020-04-01,동작구,405863.9181,312990.4167,15784,1570,14214,1
1492,2020-04-01,마포구,465991.6541,348499.1667,28401,2400,26001,1
1493,2020-04-01,서대문구,370109.7679,257081.25,15007,1489,13518,1
1494,2020-04-01,서초구,596475.562,431558.3333,36373,2535,33838,2
1495,2020-04-01,성동구,355961.118,266369.1667,17062,1322,15740,0
1496,2020-04-01,성북구,433472.7077,338655,17151,1584,15567,0
1497,2020-04-01,송파구,768396.8269,524258.3333,37428,3169,34259,1
1498,2020-04-01,양천구,407866.1336,323747.5,18372,1663,16709,0
1499,2020-04-01,영등포구,477357.5396,411020.8333,27173,2259,24914,0
1500,2020-04-01,용산구,291159.1741,216022.0833,18924,1183,17741,0
1501,2020-04-01,은평구,447481.7843,329971.25,18350,1572,16778,0
1502,2020-04-01,종로구,286501.0381,229037.0833,25318,1608,23710,1
1503,2020-04-01,중구,274971.7933,240685.4167,40015,2062,37953,0
1504,2020-04-01,중랑구,359424.1953,289737.5,16180,1286,14894,3
1505,2020-04-02,강남구,855116.3357,622468.3333,55675,4353,51322,0
1506,2020-04-02,강동구,511522.1926,329897.9167,20935,1897,19038,1
1507,2020-04-02,강북구,305512.543,234244.1667,13461,1066,12395,0
1508,2020-04-02,강서구,543743.7043,440305.8333,26009,2632,23377,0
1509,2020-04-02,관악구,489743.8613,390890.4167,19710,1903,17807,3
1510,2020-04-02,광진구,372659.894,283645.8333,18984,1668,17316,0
1511,2020-04-02,구로구,393667.8846,356053.75,22249,1798,20451,0
1512,2020-04-02,금천구,236459.4352,237134.1667,15627,1271,14356,0
1513,2020-04-02,노원구,528751.0359,392100,18235,1866,16369,1
1514,2020-04-02,도봉구,279436.7149,235479.5833,11723,983,10740,0
1515,2020-04-02,동대문구,360459.7056,293985,21157,1473,19684,0
1516,2020-04-02,동작구,405280.3613,311891.6667,15784,1570,14214,0
1517,2020-04-02,마포구,464141.573,347470,28401,2400,26001,0
1518,2020-04-02,서대문구,369687.4876,256434.5833,15007,1489,13518,0
1519,2020-04-02,서초구,597464.3418,431090.4167,36373,2535,33838,2
1520,2020-04-02,성동구,353207.6341,266021.6667,17062,1322,15740,1
1521,2020-04-02,성북구,431784.7697,337530.4167,17151,1584,15567,0
1522,2020-04-02,송파구,767623.781,522928.75,37428,3169,34259,1
1523,2020-04-02,양천구,405959.6962,323044.1667,18372,1663,16709,2
1524,2020-04-02,영등포구,475713.2344,409915.8333,27173,2259,24914,1
1525,2020-04-02,용산구,290629.3444,215497.0833,18924,1183,17741,2
1526,2020-04-02,은평구,446963.7159,329260.8333,18350,1572,16778,2
1527,2020-04-02,종로구,285763.6475,228505.4167,25318,1608,23710,1
1528,2020-04-02,중구,274919.7512,240306.25,40015,2062,37953,0
1529,2020-04-02,중랑구,358982.9115,288531.25,16180,1286,14894,1
1530,2020-04-02,중랑구,358982.9115,288531.25,16180,1286,14894,1
1531,2020-04-03,강남구,850151.9065,617673.75,55675,4353,51322,5
1532,2020-04-03,강동구,508525.8485,330147.0833,20935,1897,19038,1
1533,2020-04-03,강북구,305663.8192,234165.8333,13461,1066,12395,0
1534,2020-04-03,강서구,542088.55,439180,26009,2632,23377,0
1535,2020-04-03,관악구,488183.3583,390071.25,19710,1903,17807,0
1536,2020-04-03,광진구,373377.7037,284228.75,18984,1668,17316,0
1537,2020-04-03,구로구,392321.1951,353782.0833,22249,1798,20451,1
1538,2020-04-03,금천구,233582.2337,234285,15627,1271,14356,0
1539,2020-04-03,노원구,528873.0694,391160.4167,18235,1866,16369,1
1540,2020-04-03,도봉구,278947.1494,235239.5833,11723,983,10740,1
1541,2020-04-03,동대문구,358942.7887,292345.4167,21157,1473,19684,1
1542,2020-04-03,동작구,404276.0161,311001.25,15784,1570,14214,3
1543,2020-04-03,마포구,465802.2175,349177.0833,28401,2400,26001,0
1544,2020-04-03,서대문구,367902.0588,254977.5,15007,1489,13518,1
1545,2020-04-03,서초구,598193.1999,431356.6667,36373,2535,33838,2
1546,2020-04-03,성동구,351911.6035,265060.4167,17062,1322,15740,0
1547,2020-04-03,성북구,429705.3692,336209.1667,17151,1584,15567,0
1548,2020-04-03,송파구,764761.8831,521339.5833,37428,3169,34259,3
1549,2020-04-03,양천구,405597.5177,322499.5833,18372,1663,16709,0
1550,2020-04-03,영등포구,472310.3734,407108.75,27173,2259,24914,0
1551,2020-04-03,용산구,292713.0609,217246.6667,18924,1183,17741,0
1552,2020-04-03,은평구,446311.9232,328950.8333,18350,1572,16778,1
1553,2020-04-03,종로구,283322.0779,225460.4167,25318,1608,23710,0
1554,2020-04-03,중구,271507.7244,236633.75,40015,2062,37953,0
1555,2020-04-03,중랑구,358254.7738,288062.5,16180,1286,14894,0
1556,2020-04-04,강남구,715418.237,491629.1667,55675,4353,51322,2
1557,2020-04-04,강동구,520355.691,341417.5,20935,1897,19038,0
1558,2020-04-04,강북구,317796.6025,247740,13461,1066,12395,0
1559,2020-04-04,강서구,543232.7448,443578.3333,26009,2632,23377,1
1560,2020-04-04,관악구,510699.0421,412030.8333,19710,1903,17807,2
1561,2020-04-04,광진구,383724.8145,295563.75,18984,1668,17316,0
1562,2020-04-04,구로구,381032.3436,343177.5,22249,1798,20451,0
1563,2020-04-04,금천구,209483.1797,204082.0833,15627,1271,14356,0
1564,2020-04-04,노원구,548995.5861,414004.1667,18235,1866,16369,0
1565,2020-04-04,도봉구,291711.0991,251057.9167,11723,983,10740,0
1566,2020-04-04,동대문구,355256.8594,290298.75,21157,1473,19684,2
1567,2020-04-04,동작구,410781.9768,318223.75,15784,1570,14214,0
1568,2020-04-04,마포구,448353.1096,331637.0833,28401,2400,26001,1
1569,2020-04-04,서대문구,352346.1609,253214.5833,15007,1489,13518,2
1570,2020-04-04,서초구,524064.3724,363443.75,36373,2535,33838,0
1571,2020-04-04,성동구,333239.5132,244486.25,17062,1322,15740,0
1572,2020-04-04,성북구,437741.1035,345403.3333,17151,1584,15567,1
1573,2020-04-04,송파구,749842.2001,510323.3333,37428,3169,34259,3
1574,2020-04-04,양천구,418285.8839,339732.9167,18372,1663,16709,0
1575,2020-04-04,영등포구,418816.1029,350441.6667,27173,2259,24914,1
1576,2020-04-04,용산구,274345.6971,200137.9167,18924,1183,17741,1
1577,2020-04-04,은평구,469634.1308,353668.3333,18350,1572,16778,1
1578,2020-04-04,종로구,234808.7834,170313.3333,25318,1608,23710,0
1579,2020-04-04,중구,191862.3984,146025,40015,2062,37953,0
1580,2020-04-04,중랑구,372979.9566,303412.9167,16180,1286,14894,1
1581,2020-04-04,중랑구,372979.9566,303412.9167,16180,1286,14894,1
1582,2020-04-05,강남구,671277.173,454217.5,55675,4353,51322,0
1583,2020-04-05,강동구,523682.2066,343150.4167,20935,1897,19038,1
1584,2020-04-05,강북구,323162.198,252767.0833,13461,1066,12395,0
1585,2020-04-05,강서구,547933.4214,445528.3333,26009,2632,23377,1
1586,2020-04-05,관악구,518779.8488,419610.8333,19710,1903,17807,1
1587,2020-04-05,광진구,383927.9291,295494.1667,18984,1668,17316,0
1588,2020-04-05,구로구,385346.4584,347717.0833,22249,1798,20451,0
1589,2020-04-05,금천구,209656.9164,204615.4167,15627,1271,14356,0
1590,2020-04-05,노원구,556430.9531,421813.3333,18235,1866,16369,0
1591,2020-04-05,도봉구,298180.8926,258329.5833,11723,983,10740,0
1592,2020-04-05,동대문구,353408.5788,289545,21157,1473,19684,0
1593,2020-04-05,동작구,412945.86,318775.8333,15784,1570,14214,0
1594,2020-04-05,마포구,437391.6779,321045,28401,2400,26001,0
1595,2020-04-05,서대문구,350923.2228,252628.3333,15007,1489,13518,0
1596,2020-04-05,서초구,499151.189,343821.25,36373,2535,33838,0
1597,2020-04-05,성동구,328538.6806,239503.3333,17062,1322,15740,0
1598,2020-04-05,성북구,443406.8672,350995.4167,17151,1584,15567,2
1599,2020-04-05,송파구,744871.6767,507145.8333,37428,3169,34259,1
1600,2020-04-05,양천구,421561.1899,345239.1667,18372,1663,16709,0
1601,2020-04-05,영등포구,411469.5672,343671.6667,27173,2259,24914,1
1602,2020-04-05,용산구,268901.504,194768.3333,18924,1183,17741,2
1603,2020-04-05,은평구,478209.4613,361493.75,18350,1572,16778,1
1604,2020-04-05,종로구,219460.748,155143.3333,25318,1608,23710,0
1605,2020-04-05,중구,170965.1386,126981.6667,40015,2062,37953,0
1606,2020-04-05,중랑구,379267.8039,310011.6667,16180,1286,14894,1
1607,2020-04-06,강남구,852636.7504,621657.5,55675,4353,51322,4
1608,2020-04-06,강동구,510981.7292,330487.9167,20935,1897,19038,0
1609,2020-04-06,강북구,307133.0599,234789.5833,13461,1066,12395,0
1610,2020-04-06,강서구,545545.5109,440919.1667,26009,2632,23377,0
1611,2020-04-06,관악구,490044.3345,389934.1667,19710,1903,17807,1
1612,2020-04-06,광진구,373569.3612,282635.8333,18984,1668,17316,0
1613,2020-04-06,구로구,397418.8914,357476.25,22249,1798,20451,0
1614,2020-04-06,금천구,238527.8584,240081.6667,15627,1271,14356,0
1615,2020-04-06,노원구,530621.9323,391715.8333,18235,1866,16369,1
1616,2020-04-06,도봉구,280657.7878,235928.75,11723,983,10740,0
1617,2020-04-06,동대문구,360770.431,294088.3333,21157,1473,19684,0
1618,2020-04-06,동작구,405997.2849,310892.0833,15784,1570,14214,0
1619,2020-04-06,마포구,462827.2731,345512.0833,28401,2400,26001,0
1620,2020-04-06,서대문구,370127.3061,255675,15007,1489,13518,0
1621,2020-04-06,서초구,594727.0415,431248.3333,36373,2535,33838,0
1622,2020-04-06,성동구,352374.9334,264835.4167,17062,1322,15740,1
1623,2020-04-06,성북구,431684.4637,337289.5833,17151,1584,15567,0
1624,2020-04-06,송파구,763216.9511,521562.5,37428,3169,34259,0
1625,2020-04-06,양천구,406983.3775,324140,18372,1663,16709,0
1626,2020-04-06,영등포구,474631.2692,410104.5833,27173,2259,24914,0
1627,2020-04-06,용산구,290300.8142,214950,18924,1183,17741,0
1628,2020-04-06,은평구,449390.4722,329966.25,18350,1572,16778,0
1629,2020-04-06,종로구,285141.0798,229106.6667,25318,1608,23710,0
1630,2020-04-06,중구,275085.6779,245409.5833,40015,2062,37953,0
1631,2020-04-06,중랑구,362099.6088,289577.5,16180,1286,14894,1
1632,2020-04-07,강남구,862027.8397,627099.5833,55675,4353,51322,1
1633,2020-04-07,강동구,508861.5935,329200,20935,1897,19038,0
1634,2020-04-07,강북구,305534.7555,234018.75,13461,1066,12395,0
1635,2020-04-07,강서구,544182.988,439615,26009,2632,23377,1
1636,2020-04-07,관악구,489305.7552,389349.1667,19710,1903,17807,0
1637,2020-04-07,광진구,372105.3098,281994.1667,18984,1668,17316,0
1638,2020-04-07,구로구,395454.5157,354551.6667,22249,1798,20451,0
1639,2020-04-07,금천구,237460.7153,238165.4167,15627,1271,14356,0
1640,2020-04-07,노원구,530066.8393,390540,18235,1866,16369,0
1641,2020-04-07,도봉구,279329.6418,234388.3333,11723,983,10740,0
1642,2020-04-07,동대문구,360890.1594,293925,21157,1473,19684,1
1643,2020-04-07,동작구,405740.2643,310555.4167,15784,1570,14214,0
1644,2020-04-07,마포구,463499.1712,346271.6667,28401,2400,26001,0
1645,2020-04-07,서대문구,371063.1695,256524.5833,15007,1489,13518,0
1646,2020-04-07,서초구,597857.9715,432920.8333,36373,2535,33838,3
1647,2020-04-07,성동구,353098.6865,265890.8333,17062,1322,15740,0
1648,2020-04-07,성북구,431186.1917,336619.5833,17151,1584,15567,2
1649,2020-04-07,송파구,762539.2938,521254.5833,37428,3169,34259,0
1650,2020-04-07,양천구,405727.8247,322511.25,18372,1663,16709,0
1651,2020-04-07,영등포구,474207.2889,409731.6667,27173,2259,24914,1
1652,2020-04-07,용산구,291190.4619,216127.9167,18924,1183,17741,0
1653,2020-04-07,은평구,446971.3505,328172.5,18350,1572,16778,0
1654,2020-04-07,종로구,288748.0449,231626.25,25318,1608,23710,0
1655,2020-04-07,중구,279231.4714,246115.8333,40015,2062,37953,0
1656,2020-04-07,중랑구,359375.4486,287986.6667,16180,1286,14894,1
1657,2020-04-08,강남구,858545.1083,623710.8333,55675,4353,51322,1
1658,2020-04-08,강동구,509348.0256,329155,20935,1897,19038,0
1659,2020-04-08,강북구,305175.0124,233623.75,13461,1066,12395,0
1660,2020-04-08,강서구,544772.7236,439459.5833,26009,2632,23377,0
1661,2020-04-08,관악구,490083.6042,389692.0833,19710,1903,17807,0
1662,2020-04-08,광진구,372114.5998,282349.5833,18984,1668,17316,0
1663,2020-04-08,구로구,395518.0483,355404.5833,22249,1798,20451,0
1664,2020-04-08,금천구,237089.1554,237776.6667,15627,1271,14356,0
1665,2020-04-08,노원구,529710.2698,390290,18235,1866,16369,0
1666,2020-04-08,도봉구,278823.4582,234512.0833,11723,983,10740,1
1667,2020-04-08,동대문구,361280.4956,293635.8333,21157,1473,19684,0
1668,2020-04-08,동작구,405070.3782,310215.8333,15784,1570,14214,1
1669,2020-04-08,마포구,465389.5337,347664.5833,28401,2400,26001,3
1670,2020-04-08,서대문구,371152.547,256000.8333,15007,1489,13518,0
1671,2020-04-08,서초구,598026.5039,432307.5,36373,2535,33838,2
1672,2020-04-08,성동구,353634.3744,265918.3333,17062,1322,15740,2
1673,2020-04-08,성북구,432058.3711,336771.6667,17151,1584,15567,0
1674,2020-04-08,송파구,762596.411,520837.5,37428,3169,34259,0
1675,2020-04-08,양천구,405515.1117,322386.6667,18372,1663,16709,0
1676,2020-04-08,영등포구,474756.7736,409249.5833,27173,2259,24914,1
1677,2020-04-08,용산구,291788.3336,215785,18924,1183,17741,0
1678,2020-04-08,은평구,446481.4914,327980.8333,18350,1572,16778,0
1679,2020-04-08,종로구,289453.8566,231835,25318,1608,23710,0
1680,2020-04-08,중구,278628.9786,244559.1667,40015,2062,37953,0
1681,2020-04-08,중랑구,358955.71,287840.4167,16180,1286,14894,0
1682,2020-04-09,강남구,859756.0529,624140.4167,55675,4353,51322,1
1683,2020-04-09,강동구,507634.3683,328506.6667,20935,1897,19038,0
1684,2020-04-09,강북구,305540.4601,233408.75,13461,1066,12395,0
1685,2020-04-09,강서구,544195.5909,438454.5833,26009,2632,23377,0
1686,2020-04-09,관악구,488697.0934,389137.9167,19710,1903,17807,0
1687,2020-04-09,광진구,372023.2759,282181.25,18984,1668,17316,1
1688,2020-04-09,구로구,395465.5563,355130.4167,22249,1798,20451,0
1689,2020-04-09,금천구,237308.1003,237985,15627,1271,14356,0
1690,2020-04-09,노원구,529859.0101,390302.5,18235,1866,16369,0
1691,2020-04-09,도봉구,278457.7872,233997.9167,11723,983,10740,0
1692,2020-04-09,동대문구,361233.815,293428.75,21157,1473,19684,0
1693,2020-04-09,동작구,403781.1876,309599.1667,15784,1570,14214,0
1694,2020-04-09,마포구,465628.5145,347227.9167,28401,2400,26001,0
1695,2020-04-09,서대문구,371216.3849,256370.4167,15007,1489,13518,0
1696,2020-04-09,서초구,597948.425,432137.0833,36373,2535,33838,0
1697,2020-04-09,성동구,353521.3588,265280,17062,1322,15740,2
1698,2020-04-09,성북구,431539.3887,336524.5833,17151,1584,15567,1
1699,2020-04-09,송파구,763929.1914,520818.75,37428,3169,34259,0
1700,2020-04-09,양천구,406019.3023,321878.75,18372,1663,16709,0
1701,2020-04-09,영등포구,475464.5508,409171.6667,27173,2259,24914,0
1702,2020-04-09,용산구,292119.5765,216264.1667,18924,1183,17741,0
1703,2020-04-09,은평구,446111.9058,327590,18350,1572,16778,0
1704,2020-04-09,종로구,289213.9439,231191.25,25318,1608,23710,0
1705,2020-04-09,중구,279751.6679,246066.6667,40015,2062,37953,0
1706,2020-04-09,중랑구,358813.8352,287433.3333,16180,1286,14894,0
1707,2020-04-10,강남구,857177.3999,621119.5833,55675,4353,51322,2
1708,2020-04-10,강동구,509036.9176,329581.25,20935,1897,19038,0
1709,2020-04-10,강북구,305043.0735,233470.8333,13461,1066,12395,0
1710,2020-04-10,강서구,540174.2442,435024.1667,26009,2632,23377,0
1711,2020-04-10,관악구,487948.2127,388717.9167,19710,1903,17807,0
1712,2020-04-10,광진구,373353.8821,284024.1667,18984,1668,17316,0
1713,2020-04-10,구로구,393247.6007,353590.8333,22249,1798,20451,0
1714,2020-04-10,금천구,234417.711,234627.5,15627,1271,14356,0
1715,2020-04-10,노원구,529183.8225,390169.1667,18235,1866,16369,0
1716,2020-04-10,도봉구,278291.4132,233694.1667,11723,983,10740,0
1717,2020-04-10,동대문구,360525.6521,291990,21157,1473,19684,0
1718,2020-04-10,동작구,403334.11,310156.6667,15784,1570,14214,0
1719,2020-04-10,마포구,467231.2453,348966.6667,28401,2400,26001,0
1720,2020-04-10,서대문구,369147.8244,255048.75,15007,1489,13518,0
1721,2020-04-10,서초구,598097.4311,432112.0833,36373,2535,33838,0
1722,2020-04-10,성동구,353731.2573,265129.1667,17062,1322,15740,0
1723,2020-04-10,성북구,429808.0712,335772.5,17151,1584,15567,0
1724,2020-04-10,송파구,763235.5251,521253.75,37428,3169,34259,0
1725,2020-04-10,양천구,407337.8154,323059.5833,18372,1663,16709,1
1726,2020-04-10,영등포구,472658.746,407077.5,27173,2259,24914,0
1727,2020-04-10,용산구,293109.805,216925.4167,18924,1183,17741,0
1728,2020-04-10,은평구,446027.9632,327881.25,18350,1572,16778,0
1729,2020-04-10,종로구,287011.6935,228084.1667,25318,1608,23710,0
1730,2020-04-10,중구,274702.1314,240911.25,40015,2062,37953,0
1731,2020-04-10,중랑구,358400.9679,287073.3333,16180,1286,14894,0
1732,2020-04-11,강남구,721067.0122,493026.25,55675,4353,51322,0
1733,2020-04-11,강동구,519160.6464,339973.3333,20935,1897,19038,0
1734,2020-04-11,강북구,316420.4157,246492.0833,13461,1066,12395,0
1735,2020-04-11,강서구,543688.4346,442089.1667,26009,2632,23377,0
1736,2020-04-11,관악구,508376.0901,410322.9167,19710,1903,17807,1
1737,2020-04-11,광진구,381906.5417,294727.0833,18984,1668,17316,0
1738,2020-04-11,구로구,381937.2272,342886.25,22249,1798,20451,0
1739,2020-04-11,금천구,208538.4479,203384.1667,15627,1271,14356,0
1740,2020-04-11,노원구,547782.8364,413551.6667,18235,1866,16369,0
1741,2020-04-11,도봉구,291258.6698,249339.5833,11723,983,10740,0
1742,2020-04-11,동대문구,356027.2837,289457.9167,21157,1473,19684,0
1743,2020-04-11,동작구,410392.7872,317412.0833,15784,1570,14214,0
1744,2020-04-11,마포구,452222.3284,333847.9167,28401,2400,26001,0
1745,2020-04-11,서대문구,353168.2094,252892.9167,15007,1489,13518,0
1746,2020-04-11,서초구,525707.601,365182.0833,36373,2535,33838,0
1747,2020-04-11,성동구,333035.233,243763.75,17062,1322,15740,0
1748,2020-04-11,성북구,436827.7196,344451.6667,17151,1584,15567,0
1749,2020-04-11,송파구,750493.1743,510982.5,37428,3169,34259,0
1750,2020-04-11,양천구,418753.3497,339663.75,18372,1663,16709,0
1751,2020-04-11,영등포구,420263.3395,352130.8333,27173,2259,24914,0
1752,2020-04-11,용산구,274369.4347,199756.25,18924,1183,17741,0
1753,2020-04-11,은평구,467184.198,351737.0833,18350,1572,16778,1
1754,2020-04-11,종로구,238511.6654,172778.3333,25318,1608,23710,0
1755,2020-04-11,중구,194599.8469,147160.8333,40015,2062,37953,0
1756,2020-04-11,중랑구,372593.7072,302656.6667,16180,1286,14894,0
1757,2020-04-12,강남구,675183.6853,456256.6667,55675,4353,51322,0
1758,2020-04-12,강동구,523374.8327,342057.0833,20935,1897,19038,0
1759,2020-04-12,강북구,322200.7285,252769.1667,13461,1066,12395,0
1760,2020-04-12,강서구,548120.2988,444601.6667,26009,2632,23377,0
1761,2020-04-12,관악구,517967.5609,419759.1667,19710,1903,17807,0
1762,2020-04-12,광진구,382857.8987,294682.5,18984,1668,17316,0
1763,2020-04-12,구로구,385687.8311,347583.75,22249,1798,20451,0
1764,2020-04-12,금천구,208713.2179,203885.8333,15627,1271,14356,0
1765,2020-04-12,노원구,555424.5149,421794.5833,18235,1866,16369,0
1766,2020-04-12,도봉구,297522.9831,257750.4167,11723,983,10740,1
1767,2020-04-12,동대문구,354559.1381,289735.4167,21157,1473,19684,0
1768,2020-04-12,동작구,413029.711,318645,15784,1570,14214,1
1769,2020-04-12,마포구,439848.0815,322070.4167,28401,2400,26001,0
1770,2020-04-12,서대문구,351912.7689,252792.5,15007,1489,13518,0
1771,2020-04-12,서초구,499378.8987,343293.75,36373,2535,33838,0
1772,2020-04-12,성동구,326949.7867,237786.25,17062,1322,15740,4
1773,2020-04-12,성북구,444354.9101,350440.4167,17151,1584,15567,0
1774,2020-04-12,송파구,743836.5446,508433.75,37428,3169,34259,1
1775,2020-04-12,양천구,421901.3971,345593.75,18372,1663,16709,0
1776,2020-04-12,영등포구,409914.0988,342604.5833,27173,2259,24914,0
1777,2020-04-12,용산구,268659.1838,194590.8333,18924,1183,17741,0
1778,2020-04-12,은평구,476571.9618,359992.9167,18350,1572,16778,1
1779,2020-04-12,종로구,221280.9029,157228.3333,25318,1608,23710,0
1780,2020-04-12,중구,172181.4216,128271.25,40015,2062,37953,0
1781,2020-04-12,중랑구,378999.3889,309195,16180,1286,14894,0
1782,2020-04-13,강남구,849142.7987,618582.9167,55675,4353,51322,0
1783,2020-04-13,강동구,509158.0173,327906.6667,20935,1897,19038,0
1784,2020-04-13,강북구,305036.8933,233986.6667,13461,1066,12395,0
1785,2020-04-13,강서구,545797.6216,439208.3333,26009,2632,23377,0
1786,2020-04-13,관악구,486660.9774,388138.3333,19710,1903,17807,0
1787,2020-04-13,광진구,372038.5735,281319.1667,18984,1668,17316,0
1788,2020-04-13,구로구,396625.839,355100.4167,22249,1798,20451,0
1789,2020-04-13,금천구,238073.8139,239013.3333,15627,1271,14356,0
1790,2020-04-13,노원구,530646.6078,389970,18235,1866,16369,0
1791,2020-04-13,도봉구,279887.6221,234635.8333,11723,983,10740,0
1792,2020-04-13,동대문구,360394.8611,293658.3333,21157,1473,19684,0
1793,2020-04-13,동작구,403246.2123,308150.4167,15784,1570,14214,0
1794,2020-04-13,마포구,463557.5504,345447.0833,28401,2400,26001,0
1795,2020-04-13,서대문구,369939.6632,254991.6667,15007,1489,13518,0
1796,2020-04-13,서초구,595581.8043,431298.75,36373,2535,33838,0
1797,2020-04-13,성동구,351292.6413,262980.4167,17062,1322,15740,2
1798,2020-04-13,성북구,431676.7938,335915.4167,17151,1584,15567,1
1799,2020-04-13,송파구,761082.6997,522133.75,37428,3169,34259,0
1800,2020-04-13,양천구,406155.6071,323212.9167,18372,1663,16709,0
1801,2020-04-13,영등포구,474654.1,409983.75,27173,2259,24914,0
1802,2020-04-13,용산구,290196.2435,214461.25,18924,1183,17741,0
1803,2020-04-13,은평구,447806.9858,327865.4167,18350,1572,16778,0
1804,2020-04-13,종로구,286832.6635,229930.8333,25318,1608,23710,0
1805,2020-04-13,중구,276072.0827,245608.3333,40015,2062,37953,0
1806,2020-04-13,중랑구,360005.4946,288243.75,16180,1286,14894,0
1807,2020-04-14,강남구,860879.4375,626690,55675,4353,51322,0
1808,2020-04-14,강동구,506698.7125,326951.6667,20935,1897,19038,0
1809,2020-04-14,강북구,303663.5619,232620.4167,13461,1066,12395,0
1810,2020-04-14,강서구,543372.0994,437191.25,26009,2632,23377,0
1811,2020-04-14,관악구,485888.6674,386671.25,19710,1903,17807,0
1812,2020-04-14,광진구,371220.7603,281011.6667,18984,1668,17316,0
1813,2020-04-14,구로구,395874.2813,354597.5,22249,1798,20451,0
1814,2020-04-14,금천구,236098.2299,235571.6667,15627,1271,14356,0
1815,2020-04-14,노원구,528688.4162,388410,18235,1866,16369,0
1816,2020-04-14,도봉구,278772.0665,232992.9167,11723,983,10740,0
1817,2020-04-14,동대문구,358515.9444,291615,21157,1473,19684,0
1818,2020-04-14,동작구,401599.495,307542.5,15784,1570,14214,1
1819,2020-04-14,마포구,467069.718,349216.6667,28401,2400,26001,0
1820,2020-04-14,서대문구,369877.6847,255202.5,15007,1489,13518,0
1821,2020-04-14,서초구,600933.8424,435410.4167,36373,2535,33838,2
1822,2020-04-14,성동구,353495.0571,265028.75,17062,1322,15740,1
1823,2020-04-14,성북구,429922.6662,334513.75,17151,1584,15567,0
1824,2020-04-14,송파구,761162.3227,520671.6667,37428,3169,34259,0
1825,2020-04-14,양천구,404578.8429,321313.3333,18372,1663,16709,0
1826,2020-04-14,영등포구,476909.9842,409722.0833,27173,2259,24914,0
1827,2020-04-14,용산구,292166.5394,216904.5833,18924,1183,17741,0
1828,2020-04-14,은평구,444330.781,325174.5833,18350,1572,16778,0
1829,2020-04-14,종로구,293355.09,234683.3333,25318,1608,23710,0
1830,2020-04-14,중구,281446.5535,247920,40015,2062,37953,1
1831,2020-04-14,중랑구,357841.6246,285652.0833,16180,1286,14894,0
1832,2020-04-15,강남구,707956.3891,481001.6667,55675,4353,51322,0
1833,2020-04-15,강동구,523529.1245,341761.25,20935,1897,19038,0
1834,2020-04-15,강북구,320010.9037,249134.1667,13461,1066,12395,0
1835,2020-04-15,강서구,552091.8287,446606.25,26009,2632,23377,0
1836,2020-04-15,관악구,516292.796,418952.9167,19710,1903,17807,0
1837,2020-04-15,광진구,384405.8451,296399.5833,18984,1668,17316,0
1838,2020-04-15,구로구,386084.0754,348173.75,22249,1798,20451,0
1839,2020-04-15,금천구,212764.469,208170.4167,15627,1271,14356,0
1840,2020-04-15,노원구,552655.4477,417581.25,18235,1866,16369,0
1841,2020-04-15,도봉구,293381.3625,252760.8333,11723,983,10740,0
1842,2020-04-15,동대문구,359260.5692,293843.3333,21157,1473,19684,0
1843,2020-04-15,동작구,415041.535,319959.1667,15784,1570,14214,0
1844,2020-04-15,마포구,448502.281,330560.4167,28401,2400,26001,0
1845,2020-04-15,서대문구,355217.0273,254452.9167,15007,1489,13518,1
1846,2020-04-15,서초구,517834.2412,358782.9167,36373,2535,33838,0
1847,2020-04-15,성동구,337995.8057,247114.1667,17062,1322,15740,0
1848,2020-04-15,성북구,444185.7347,351646.6667,17151,1584,15567,0
1849,2020-04-15,송파구,754228.5301,515439.5833,37428,3169,34259,0
1850,2020-04-15,양천구,420267.8771,343535,18372,1663,16709,0
1851,2020-04-15,영등포구,423215.0271,354407.9167,27173,2259,24914,0
1852,2020-04-15,용산구,271355.2581,198001.25,18924,1183,17741,0
1853,2020-04-15,은평구,472628.2329,355066.6667,18350,1572,16778,0
1854,2020-04-15,종로구,240081.8135,174787.0833,25318,1608,23710,0
1855,2020-04-15,중구,198322.8405,150280.8333,40015,2062,37953,0
1856,2020-04-15,중랑구,377502.7665,307476.6667,16180,1286,14894,0
1857,2020-04-16,강남구,855050.4571,621934.1667,55675,4353,51322,1
1858,2020-04-16,강동구,509225.0135,327617.5,20935,1897,19038,0
1859,2020-04-16,강북구,305124.9954,232926.6667,13461,1066,12395,0
1860,2020-04-16,강서구,544701.5297,438089.5833,26009,2632,23377,0
1861,2020-04-16,관악구,486566.4748,387585.8333,19710,1903,17807,0
1862,2020-04-16,광진구,372128.3598,281607.0833,18984,1668,17316,0
1863,2020-04-16,구로구,395681.6156,355324.1667,22249,1798,20451,0
1864,2020-04-16,금천구,236480.742,236455.8333,15627,1271,14356,0
1865,2020-04-16,노원구,530746.7056,389860,18235,1866,16369,0
1866,2020-04-16,도봉구,278988.2391,233877.5,11723,983,10740,0
1867,2020-04-16,동대문구,359707.8506,291367.9167,21157,1473,19684,0
1868,2020-04-16,동작구,403390.0313,307383.75,15784,1570,14214,0
1869,2020-04-16,마포구,464915.2276,347064.1667,28401,2400,26001,0
1870,2020-04-16,서대문구,369438.0684,255168.75,15007,1489,13518,0
1871,2020-04-16,서초구,595234.3217,431142.9167,36373,2535,33838,0
1872,2020-04-16,성동구,352301.3215,263859.1667,17062,1322,15740,0
1873,2020-04-16,성북구,431281.6033,335675.4167,17151,1584,15567,0
1874,2020-04-16,송파구,761346.1538,520120,37428,3169,34259,0
1875,2020-04-16,양천구,406351.5447,322293.75,18372,1663,16709,0
1876,2020-04-16,영등포구,474241.9601,409560,27173,2259,24914,0
1877,2020-04-16,용산구,291663.8632,215190.8333,18924,1183,17741,1
1878,2020-04-16,은평구,446376.4189,326574.1667,18350,1572,16778,0
1879,2020-04-16,종로구,289577.5814,231814.1667,25318,1608,23710,0
1880,2020-04-16,중구,276491.3645,245048.3333,40015,2062,37953,0
1881,2020-04-16,중랑구,359004.1714,286621.6667,16180,1286,14894,0
1882,2020-04-17,강남구,856749.6963,623667.0833,55675,4353,51322,1
1883,2020-04-17,강동구,511685.9231,330089.1667,20935,1897,19038,0
1884,2020-04-17,강북구,306236.4012,235097.0833,13461,1066,12395,0
1885,2020-04-17,강서구,544878.0944,439135.8333,26009,2632,23377,0
1886,2020-04-17,관악구,487993.6,389041.25,19710,1903,17807,0
1887,2020-04-17,광진구,373563.6804,282016.25,18984,1668,17316,0
1888,2020-04-17,구로구,396317.8088,356576.25,22249,1798,20451,0
1889,2020-04-17,금천구,235926.8683,235766.6667,15627,1271,14356,0
1890,2020-04-17,노원구,532172.0094,391794.5833,18235,1866,16369,0
1891,2020-04-17,도봉구,279269.2719,235003.75,11723,983,10740,0
1892,2020-04-17,동대문구,359800.5451,291950.4167,21157,1473,19684,0
1893,2020-04-17,동작구,403858.8564,309130.8333,15784,1570,14214,0
1894,2020-04-17,마포구,466175.1757,348429.5833,28401,2400,26001,0
1895,2020-04-17,서대문구,369358.2269,254758.75,15007,1489,13518,0
1896,2020-04-17,서초구,597667.5139,433136.6667,36373,2535,33838,0
1897,2020-04-17,성동구,352740.0838,263111.6667,17062,1322,15740,0
1898,2020-04-17,성북구,431519.0024,335657.5,17151,1584,15567,1
1899,2020-04-17,송파구,763589.8788,522478.75,37428,3169,34259,0
1900,2020-04-17,양천구,407391.7643,323637.5,18372,1663,16709,0
1901,2020-04-17,영등포구,474684.0311,409184.5833,27173,2259,24914,0
1902,2020-04-17,용산구,291822.1317,215273.75,18924,1183,17741,0
1903,2020-04-17,은평구,448291.3462,328717.9167,18350,1572,16778,0
1904,2020-04-17,종로구,285660.0344,227142.5,25318,1608,23710,0
1905,2020-04-17,중구,273085.4525,239317.9167,40015,2062,37953,0
1906,2020-04-17,중랑구,360221.1278,288495,16180,1286,14894,0
1907,2020-04-18,강남구,725225.9577,497144.1667,55675,4353,51322,1
1908,2020-04-18,강동구,523144.9954,338356.25,20935,1897,19038,0
1909,2020-04-18,강북구,314717.7724,245139.5833,13461,1066,12395,0
1910,2020-04-18,강서구,543420.9297,440540.4167,26009,2632,23377,0
1911,2020-04-18,관악구,508099.6064,410100,19710,1903,17807,0
1912,2020-04-18,광진구,384066.2354,293520.8333,18984,1668,17316,0
1913,2020-04-18,구로구,380656.1779,341284.1667,22249,1798,20451,0
1914,2020-04-18,금천구,207632.1338,201273.75,15627,1271,14356,0
1915,2020-04-18,노원구,545666.2748,411263.75,18235,1866,16369,0
1916,2020-04-18,도봉구,290259.114,248141.25,11723,983,10740,0
1917,2020-04-18,동대문구,354641.8223,287670,21157,1473,19684,0
1918,2020-04-18,동작구,408635.3657,315331.25,15784,1570,14214,0
1919,2020-04-18,마포구,455640.9008,335573.75,28401,2400,26001,0
1920,2020-04-18,서대문구,351544.7075,251302.0833,15007,1489,13518,0
1921,2020-04-18,서초구,528268.2527,367752.9167,36373,2535,33838,0
1922,2020-04-18,성동구,334021.1898,243872.9167,17062,1322,15740,0
1923,2020-04-18,성북구,435384.0622,341930.8333,17151,1584,15567,0
1924,2020-04-18,송파구,750827.3026,511450.8333,37428,3169,34259,0
1925,2020-04-18,양천구,416604.305,337574.1667,18372,1663,16709,0
1926,2020-04-18,영등포구,424136.2063,352557.5,27173,2259,24914,0
1927,2020-04-18,용산구,278095.2482,202822.5,18924,1183,17741,0
1928,2020-04-18,은평구,467325.7085,349655,18350,1572,16778,0
1929,2020-04-18,종로구,244963.0675,177564.5833,25318,1608,23710,0
1930,2020-04-18,중구,197484.1409,150749.1667,40015,2062,37953,0
1931,2020-04-18,중랑구,370384.8242,300433.3333,16180,1286,14894,0
1932,2020-04-19,강남구,681264.0347,459596.6667,55675,4353,51322,0
1933,2020-04-19,강동구,526162.9992,343022.0833,20935,1897,19038,0
1934,2020-04-19,강북구,322821.5705,252155.8333,13461,1066,12395,0
1935,2020-04-19,강서구,551928.6294,446397.0833,26009,2632,23377,1
1936,2020-04-19,관악구,520178.0962,420495.8333,19710,1903,17807,0
1937,2020-04-19,광진구,384299.9337,294220,18984,1668,17316,0
1938,2020-04-19,구로구,387516.9225,347941.25,22249,1798,20451,0
1939,2020-04-19,금천구,208743.4658,203145,15627,1271,14356,0
1940,2020-04-19,노원구,557039.8282,422327.0833,18235,1866,16369,0
1941,2020-04-19,도봉구,297715.973,258039.1667,11723,983,10740,0
1942,2020-04-19,동대문구,356588.9653,289800.4167,21157,1473,19684,0
1943,2020-04-19,동작구,413473.4195,318702.0833,15784,1570,14214,0
1944,2020-04-19,마포구,439670.4928,321778.3333,28401,2400,26001,0
1945,2020-04-19,서대문구,352217.5722,252135.4167,15007,1489,13518,0
1946,2020-04-19,서초구,503712.468,346221.6667,36373,2535,33838,0
1947,2020-04-19,성동구,328006.0391,237885,17062,1322,15740,0
1948,2020-04-19,성북구,445362.24,350078.75,17151,1584,15567,0
1949,2020-04-19,송파구,746786.597,509324.1667,37428,3169,34259,0
1950,2020-04-19,양천구,422805.1096,346329.5833,18372,1663,16709,0
1951,2020-04-19,영등포구,413434.5899,343828.3333,27173,2259,24914,0
1952,2020-04-19,용산구,270303.5027,195007.0833,18924,1183,17741,0
1953,2020-04-19,은평구,480124.7982,360821.6667,18350,1572,16778,0
1954,2020-04-19,종로구,221880.5643,156383.3333,25318,1608,23710,0
1955,2020-04-19,중구,172770.1454,129034.5833,40015,2062,37953,0
1956,2020-04-19,중랑구,379937.7279,309990,16180,1286,14894,0
1957,2020-04-20,강남구,859503.8301,625754.5833,55675,4353,51322,0
1958,2020-04-20,강동구,512973.2469,328932.9167,20935,1897,19038,0
1959,2020-04-20,강북구,306421.3405,233553.3333,13461,1066,12395,0
1960,2020-04-20,강서구,548110.1782,439889.1667,26009,2632,23377,0
1961,2020-04-20,관악구,489230.5887,388947.5,19710,1903,17807,0
1962,2020-04-20,광진구,373195.5438,280311.6667,18984,1668,17316,0
1963,2020-04-20,구로구,398612.0338,357140.4167,22249,1798,20451,0
1964,2020-04-20,금천구,238051.2969,238573.75,15627,1271,14356,0
1965,2020-04-20,노원구,531984.3345,389913.75,18235,1866,16369,0
1966,2020-04-20,도봉구,280628.3936,235172.5,11723,983,10740,0
1967,2020-04-20,동대문구,362096.8119,293111.6667,21157,1473,19684,0
1968,2020-04-20,동작구,406055.2947,309478.3333,15784,1570,14214,0
1969,2020-04-20,마포구,463451.9184,345596.6667,28401,2400,26001,1
1970,2020-04-20,서대문구,371454.0041,254966.25,15007,1489,13518,0
1971,2020-04-20,서초구,598926.9179,431766.25,36373,2535,33838,0
1972,2020-04-20,성동구,352216.8326,263072.5,17062,1322,15740,0
1973,2020-04-20,성북구,433265.1761,335305.8333,17151,1584,15567,0
1974,2020-04-20,송파구,764181.9026,521732.9167,37428,3169,34259,0
1975,2020-04-20,양천구,407270.2368,322583.75,18372,1663,16709,0
1976,2020-04-20,영등포구,478159.3845,411328.75,27173,2259,24914,0
1977,2020-04-20,용산구,291388.1725,214825.8333,18924,1183,17741,0
1978,2020-04-20,은평구,449816.3115,327834.5833,18350,1572,16778,0
1979,2020-04-20,종로구,289712.5983,231366.25,25318,1608,23710,0
1980,2020-04-20,중구,278150.6653,248479.5833,40015,2062,37953,0
1981,2020-04-20,중랑구,360597.557,288240,16180,1286,14894,0
1982,2020-04-21,강남구,870456.0539,632280.8333,55675,4353,51322,0
1983,2020-04-21,강동구,513209.4189,327732.0833,20935,1897,19038,0
1984,2020-04-21,강북구,304971.3603,232395.8333,13461,1066,12395,0
1985,2020-04-21,강서구,545673.6181,438108.75,26009,2632,23377,0
1986,2020-04-21,관악구,488053.2691,387293.75,19710,1903,17807,0
1987,2020-04-21,광진구,372000.1407,279300.4167,18984,1668,17316,0
1988,2020-04-21,구로구,395840.279,353581.6667,22249,1798,20451,0
1989,2020-04-21,금천구,237317.2897,236582.5,15627,1271,14356,0
1990,2020-04-21,노원구,527954.1793,388470.4167,18235,1866,16369,0
1991,2020-04-21,도봉구,280671.5778,233012.5,11723,983,10740,0
1992,2020-04-21,동대문구,361929.263,292561.25,21157,1473,19684,0
1993,2020-04-21,동작구,404166.022,308695.8333,15784,1570,14214,0
1994,2020-04-21,마포구,465809.1131,346663.75,28401,2400,26001,1
1995,2020-04-21,서대문구,372848.1997,255741.25,15007,1489,13518,0
1996,2020-04-21,서초구,605004.6257,435588.3333,36373,2535,33838,0
1997,2020-04-21,성동구,353569.6213,262799.1667,17062,1322,15740,0
1998,2020-04-21,성북구,431478.7667,333563.3333,17151,1584,15567,0
1999,2020-04-21,송파구,763960.6377,521495,37428,3169,34259,0
2000,2020-04-21,양천구,406158.6825,320468.3333,18372,1663,16709,0
2001,2020-04-21,영등포구,479945.1923,411385.4167,27173,2259,24914,0
2002,2020-04-21,용산구,293486.0829,215683.75,18924,1183,17741,0
2003,2020-04-21,은평구,447289.0976,325885.4167,18350,1572,16778,0
2004,2020-04-21,종로구,294975.8456,235666.6667,25318,1608,23710,0
2005,2020-04-21,중구,282812.361,251180.4167,40015,2062,37953,0
2006,2020-04-21,중랑구,357671.1015,285524.5833,16180,1286,14894,1
2007,2020-04-22,강남구,869601.1968,631310.4167,55675,4353,51322,0
2008,2020-04-22,강동구,511431.871,328165.4167,20935,1897,19038,0
2009,2020-04-22,강북구,304766.3401,232190.4167,13461,1066,12395,0
2010,2020-04-22,강서구,546721.9877,439085,26009,2632,23377,0
2011,2020-04-22,관악구,487975.1466,387591.25,19710,1903,17807,0
2012,2020-04-22,광진구,371441.9768,279716.6667,18984,1668,17316,0
2013,2020-04-22,구로구,395876.4422,354551.25,22249,1798,20451,0
2014,2020-04-22,금천구,236689.5218,235913.75,15627,1271,14356,0
2015,2020-04-22,노원구,527701.9465,388242.5,18235,1866,16369,0
2016,2020-04-22,도봉구,280982.0231,233695,11723,983,10740,0
2017,2020-04-22,동대문구,362460.3269,292960.8333,21157,1473,19684,0
2018,2020-04-22,동작구,405244.1272,309815.4167,15784,1570,14214,0
2019,2020-04-22,마포구,465326.538,346496.6667,28401,2400,26001,0
2020,2020-04-22,서대문구,372410.822,255452.9167,15007,1489,13518,0
2021,2020-04-22,서초구,603749.1836,435784.1667,36373,2535,33838,0
2022,2020-04-22,성동구,352445.8779,262623.75,17062,1322,15740,0
2023,2020-04-22,성북구,431805.9432,333985,17151,1584,15567,0
2024,2020-04-22,송파구,763649.3793,521326.6667,37428,3169,34259,0
2025,2020-04-22,양천구,405572.7471,320633.75,18372,1663,16709,0
2026,2020-04-22,영등포구,477822.0503,410436.6667,27173,2259,24914,0
2027,2020-04-22,용산구,293535.3782,215744.5833,18924,1183,17741,0
2028,2020-04-22,은평구,447533.2815,326190.8333,18350,1572,16778,0
2029,2020-04-22,종로구,293686.1343,234910.8333,25318,1608,23710,0
2030,2020-04-22,중구,281220.1291,250465,40015,2062,37953,0
2031,2020-04-22,중랑구,357489.8854,285744.5833,16180,1286,14894,0
2032,2020-04-23,강남구,871710.6121,632585,55675,4353,51322,0
2033,2020-04-23,강동구,508325.8111,327343.3333,20935,1897,19038,0
2034,2020-04-23,강북구,303386.5645,231861.6667,13461,1066,12395,0
2035,2020-04-23,강서구,544337.0086,437092.0833,26009,2632,23377,0
2036,2020-04-23,관악구,485662.6158,386185.8333,19710,1903,17807,0
2037,2020-04-23,광진구,372049.6836,279851.6667,18984,1668,17316,0
2038,2020-04-23,구로구,395055.1117,354166.25,22249,1798,20451,0
2039,2020-04-23,금천구,236302.8183,235900.8333,15627,1271,14356,0
2040,2020-04-23,노원구,525780.9639,386271.25,18235,1866,16369,0
2041,2020-04-23,도봉구,280340.2214,232745,11723,983,10740,0
2042,2020-04-23,동대문구,361602.0986,292034.5833,21157,1473,19684,0
2043,2020-04-23,동작구,403202.2673,308553.75,15784,1570,14214,0
2044,2020-04-23,마포구,466897.0772,347835,28401,2400,26001,0
2045,2020-04-23,서대문구,371992.1395,254997.9167,15007,1489,13518,0
2046,2020-04-23,서초구,604843.379,437251.6667,36373,2535,33838,0
2047,2020-04-23,성동구,352444.3595,262370.8333,17062,1322,15740,0
2048,2020-04-23,성북구,430833.2005,333380,17151,1584,15567,0
2049,2020-04-23,송파구,761695.8549,520132.9167,37428,3169,34259,0
2050,2020-04-23,양천구,404217.179,319728.75,18372,1663,16709,0
2051,2020-04-23,영등포구,479422.7823,410918.3333,27173,2259,24914,0
2052,2020-04-23,용산구,294921.0205,216664.1667,18924,1183,17741,0
2053,2020-04-23,은평구,445115.0894,325409.5833,18350,1572,16778,0
2054,2020-04-23,종로구,296468.615,236630.4167,25318,1608,23710,0
2055,2020-04-23,중구,283217.7079,252467.9167,40015,2062,37953,0
2056,2020-04-23,중랑구,356416.4947,284709.1667,16180,1286,14894,0
2057,2020-04-24,강남구,868678.1629,632166.25,55675,4353,51322,0
2058,2020-04-24,강동구,508464.36,327540.8333,20935,1897,19038,0
2059,2020-04-24,강북구,302928.316,231639.1667,13461,1066,12395,0
2060,2020-04-24,강서구,542719.1804,436138.75,26009,2632,23377,0
2061,2020-04-24,관악구,484402.817,385979.5833,19710,1903,17807,0
2062,2020-04-24,광진구,371336.5619,281033.3333,18984,1668,17316,0
2063,2020-04-24,구로구,392811.4987,352254.1667,22249,1798,20451,1
2064,2020-04-24,금천구,233872.313,233914.1667,15627,1271,14356,0
2065,2020-04-24,노원구,524323.3556,386412.5,18235,1866,16369,0
2066,2020-04-24,도봉구,278950.7535,231826.6667,11723,983,10740,0
2067,2020-04-24,동대문구,360232.5817,291172.9167,21157,1473,19684,0
2068,2020-04-24,동작구,402719.926,308832.5,15784,1570,14214,0
2069,2020-04-24,마포구,469357.7491,350993.75,28401,2400,26001,0
2070,2020-04-24,서대문구,368022.1375,253474.5833,15007,1489,13518,0
2071,2020-04-24,서초구,604490.0014,438937.9167,36373,2535,33838,0
2072,2020-04-24,성동구,351642.3705,262022.5,17062,1322,15740,0
2073,2020-04-24,성북구,427264.309,331415.8333,17151,1584,15567,0
2074,2020-04-24,송파구,760511.6808,520675.4167,37428,3169,34259,0
2075,2020-04-24,양천구,402888.0663,320035.4167,18372,1663,16709,0
2076,2020-04-24,영등포구,476932.15,409993.75,27173,2259,24914,0
2077,2020-04-24,용산구,296703.0575,218787.0833,18924,1183,17741,0
2078,2020-04-24,은평구,443531.0771,324192.0833,18350,1572,16778,0
2079,2020-04-24,종로구,294237.1522,234705.4167,25318,1608,23710,0
2080,2020-04-24,중구,280768.211,249232.5,40015,2062,37953,0
2081,2020-04-24,중랑구,355474.0018,284120.4167,16180,1286,14894,0
2082,2020-04-25,강남구,734170.9389,505340.8333,55675,4353,51322,0
2083,2020-04-25,강동구,516122.3789,338285,20935,1897,19038,0
2084,2020-04-25,강북구,313253.375,244398.3333,13461,1066,12395,0
2085,2020-04-25,강서구,541454.6474,441107.9167,26009,2632,23377,0
2086,2020-04-25,관악구,503140.1075,409434.1667,19710,1903,17807,0
2087,2020-04-25,광진구,381053.398,292526.6667,18984,1668,17316,0
2088,2020-04-25,구로구,379381.8908,341681.6667,22249,1798,20451,0
2089,2020-04-25,금천구,206708.2122,201196.6667,15627,1271,14356,0
2090,2020-04-25,노원구,540256.795,408985,18235,1866,16369,0
2091,2020-04-25,도봉구,289846.358,246984.1667,11723,983,10740,0
2092,2020-04-25,동대문구,354777.2772,288521.25,21157,1473,19684,0
2093,2020-04-25,동작구,407684.0858,316865.8333,15784,1570,14214,0
2094,2020-04-25,마포구,454090.8423,336465.8333,28401,2400,26001,0
2095,2020-04-25,서대문구,350471.9284,251522.5,15007,1489,13518,0
2096,2020-04-25,서초구,533199.8712,373297.5,36373,2535,33838,0
2097,2020-04-25,성동구,331297.9822,242007.9167,17062,1322,15740,0
2098,2020-04-25,성북구,433329.483,339922.9167,17151,1584,15567,0
2099,2020-04-25,송파구,747042.2023,511846.25,37428,3169,34259,0
2100,2020-04-25,양천구,413661.6909,335834.1667,18372,1663,16709,0
2101,2020-04-25,영등포구,423703.07,354181.6667,27173,2259,24914,0
2102,2020-04-25,용산구,280010.2928,203902.5,18924,1183,17741,0
2103,2020-04-25,은평구,463977.5978,347868.3333,18350,1572,16778,0
2104,2020-04-25,종로구,247301.1895,180703.3333,25318,1608,23710,0
2105,2020-04-25,중구,200188.6341,155197.5,40015,2062,37953,0
2106,2020-04-25,중랑구,367983.5227,299732.9167,16180,1286,14894,0
2107,2020-04-26,강남구,684547.26,462395.4167,55675,4353,51322,0
2108,2020-04-26,강동구,521289.5282,340755.8333,20935,1897,19038,0
2109,2020-04-26,강북구,319549.8452,250071.6667,13461,1066,12395,0
2110,2020-04-26,강서구,546217.2859,443280.4167,26009,2632,23377,0
2111,2020-04-26,관악구,513801.5746,417379.5833,19710,1903,17807,0
2112,2020-04-26,광진구,383461.6526,293816.25,18984,1668,17316,0
2113,2020-04-26,구로구,383922.3333,344565.8333,22249,1798,20451,0
2114,2020-04-26,금천구,206654.5911,200239.1667,15627,1271,14356,0
2115,2020-04-26,노원구,548180.3216,416030,18235,1866,16369,0
2116,2020-04-26,도봉구,297457.9408,255089.1667,11723,983,10740,0
2117,2020-04-26,동대문구,353873.7786,287035,21157,1473,19684,0
2118,2020-04-26,동작구,409313.4855,315727.9167,15784,1570,14214,0
2119,2020-04-26,마포구,444356.0508,324805.8333,28401,2400,26001,0
2120,2020-04-26,서대문구,349313.003,250501.25,15007,1489,13518,0
2121,2020-04-26,서초구,504641.4369,347890,36373,2535,33838,0
2122,2020-04-26,성동구,326352.4102,236989.5833,17062,1322,15740,0
2123,2020-04-26,성북구,439892.2225,345049.5833,17151,1584,15567,0
2124,2020-04-26,송파구,741761.2859,507613.75,37428,3169,34259,0
2125,2020-04-26,양천구,417813.6828,341188.3333,18372,1663,16709,0
2126,2020-04-26,영등포구,415423.9922,344769.1667,27173,2259,24914,0
2127,2020-04-26,용산구,275472.7236,198370.4167,18924,1183,17741,0
2128,2020-04-26,은평구,472728.5051,355203.75,18350,1572,16778,0
2129,2020-04-26,종로구,230870.5025,164131.6667,25318,1608,23710,0
2130,2020-04-26,중구,176537.7363,133492.9167,40015,2062,37953,0
2131,2020-04-26,중랑구,374654.9032,305235.4167,16180,1286,14894,0
2132,2020-04-27,강남구,863349.6064,631531.25,55675,4353,51322,2
2133,2020-04-27,강동구,508903.6949,326362.9167,20935,1897,19038,0
2134,2020-04-27,강북구,303333.1785,231910.4167,13461,1066,12395,0
2135,2020-04-27,강서구,543444.1469,437419.5833,26009,2632,23377,0
2136,2020-04-27,관악구,483659.9323,385295.4167,19710,1903,17807,1
2137,2020-04-27,광진구,370727.0207,279765.4167,18984,1668,17316,0
2138,2020-04-27,구로구,396558.6647,354600,22249,1798,20451,0
2139,2020-04-27,금천구,236792.9266,237610.8333,15627,1271,14356,0
2140,2020-04-27,노원구,526313.0736,386174.1667,18235,1866,16369,0
2141,2020-04-27,도봉구,279383.196,232475,11723,983,10740,0
2142,2020-04-27,동대문구,360932.5267,292249.1667,21157,1473,19684,0
2143,2020-04-27,동작구,402564.8821,308335.4167,15784,1570,14214,0
2144,2020-04-27,마포구,463701.1613,346435.4167,28401,2400,26001,0
2145,2020-04-27,서대문구,370421.7628,254243.3333,15007,1489,13518,0
2146,2020-04-27,서초구,600754.3767,436545.4167,36373,2535,33838,0
2147,2020-04-27,성동구,351284.3715,261767.9167,17062,1322,15740,0
2148,2020-04-27,성북구,428795.8956,331781.6667,17151,1584,15567,1
2149,2020-04-27,송파구,758856.3178,519800,37428,3169,34259,0
2150,2020-04-27,양천구,404124.6149,319496.25,18372,1663,16709,0
2151,2020-04-27,영등포구,479044.1929,412430.4167,27173,2259,24914,0
2152,2020-04-27,용산구,293719.7334,215605.4167,18924,1183,17741,0
2153,2020-04-27,은평구,444610.8606,324135,18350,1572,16778,0
2154,2020-04-27,종로구,293629.6114,235734.5833,25318,1608,23710,0
2155,2020-04-27,중구,281668.612,253228.75,40015,2062,37953,0
2156,2020-04-27,중랑구,357467.1113,284928.75,16180,1286,14894,0
2157,2020-04-28,강남구,876459.5602,638419.1667,55675,4353,51322,0
2158,2020-04-28,강동구,505966.5911,324952.0833,20935,1897,19038,0
2159,2020-04-28,강북구,301432.1145,230222.5,13461,1066,12395,0
2160,2020-04-28,강서구,543221.1551,435416.6667,26009,2632,23377,0
2161,2020-04-28,관악구,481783.8301,383335,19710,1903,17807,0
2162,2020-04-28,광진구,368252.388,278079.5833,18984,1668,17316,0
2163,2020-04-28,구로구,392988.9858,351009.1667,22249,1798,20451,0
2164,2020-04-28,금천구,236049.3078,235825.4167,15627,1271,14356,0
2165,2020-04-28,노원구,523444.8974,384508.3333,18235,1866,16369,0
2166,2020-04-28,도봉구,278286.5567,230376.25,11723,983,10740,0
2167,2020-04-28,동대문구,360312.8291,290991.6667,21157,1473,19684,0
2168,2020-04-28,동작구,402077.2609,307957.9167,15784,1570,14214,0
2169,2020-04-28,마포구,465977.9386,347867.9167,28401,2400,26001,0
2170,2020-04-28,서대문구,371688.2708,253578.3333,15007,1489,13518,0
2171,2020-04-28,서초구,608325.2513,439815.4167,36373,2535,33838,0
2172,2020-04-28,성동구,352170.4314,262777.9167,17062,1322,15740,0
2173,2020-04-28,성북구,427921.0227,330427.9167,17151,1584,15567,0
2174,2020-04-28,송파구,759298.463,519295.8333,37428,3169,34259,0
2175,2020-04-28,양천구,402016.9836,318086.25,18372,1663,16709,0
2176,2020-04-28,영등포구,481233.3185,413527.9167,27173,2259,24914,0
2177,2020-04-28,용산구,295396.6811,217209.5833,18924,1183,17741,0
2178,2020-04-28,은평구,441602.5522,321816.6667,18350,1572,16778,0
2179,2020-04-28,종로구,299771.7808,239915.4167,25318,1608,23710,0
2180,2020-04-28,중구,287085.7291,257054.5833,40015,2062,37953,0
2181,2020-04-28,중랑구,355086.1429,282556.25,16180,1286,14894,0
2182,2020-04-29,강남구,871780.1304,635835,55675,4353,51322,0
2183,2020-04-29,강동구,503922.4903,323417.5,20935,1897,19038,0
2184,2020-04-29,강북구,300770.6457,229473.3333,13461,1066,12395,0
2185,2020-04-29,강서구,541259.4511,434556.25,26009,2632,23377,0
2186,2020-04-29,관악구,478601.9858,381247.5,19710,1903,17807,0
2187,2020-04-29,광진구,369254.1412,278985.4167,18984,1668,17316,0
2188,2020-04-29,구로구,392028.1929,350506.25,22249,1798,20451,0
2189,2020-04-29,금천구,234802.1004,233096.25,15627,1271,14356,0
2190,2020-04-29,노원구,521210.7095,382915,18235,1866,16369,0
2191,2020-04-29,도봉구,276709.7451,229105.4167,11723,983,10740,0
2192,2020-04-29,동대문구,358719.3992,288312.5,21157,1473,19684,0
2193,2020-04-29,동작구,400071.4818,306805,15784,1570,14214,0
2194,2020-04-29,마포구,468539.256,350683.3333,28401,2400,26001,0
2195,2020-04-29,서대문구,368718.6628,252498.75,15007,1489,13518,0
2196,2020-04-29,서초구,608229.1253,440547.5,36373,2535,33838,0
2197,2020-04-29,성동구,351802.7399,262669.5833,17062,1322,15740,0
2198,2020-04-29,성북구,425811.6046,328322.5,17151,1584,15567,0
2199,2020-04-29,송파구,754081.7744,515983.3333,37428,3169,34259,0
2200,2020-04-29,양천구,400211.4596,315949.1667,18372,1663,16709,0
2201,2020-04-29,영등포구,481162.6837,412978.3333,27173,2259,24914,0
2202,2020-04-29,용산구,298033.3294,219510.8333,18924,1183,17741,0
2203,2020-04-29,은평구,439212.6047,319467.5,18350,1572,16778,0
2204,2020-04-29,종로구,301214.9675,241104.1667,25318,1608,23710,0
2205,2020-04-29,중구,287180.3908,255818.75,40015,2062,37953,0
2206,2020-04-29,중랑구,353568.006,281040.4167,16180,1286,14894,0
2207,2020-04-30,강남구,696961.7668,479735,55675,4353,51322,0
2208,2020-04-30,강동구,503823.6424,331520.8333,20935,1897,19038,0
2209,2020-04-30,강북구,309338.3935,242604.5833,13461,1066,12395,0
2210,2020-04-30,강서구,528151.4495,430590,26009,2632,23377,0
2211,2020-04-30,관악구,486195.8847,397674.5833,19710,1903,17807,0
2212,2020-04-30,광진구,372121.4066,286960.8333,18984,1668,17316,0
2213,2020-04-30,구로구,365023.9626,331272.0833,22249,1798,20451,0
2214,2020-04-30,금천구,200670.3354,197459.5833,15627,1271,14356,0
2215,2020-04-30,노원구,526524.4552,402600.4167,18235,1866,16369,0
2216,2020-04-30,도봉구,285069.3254,245359.5833,11723,983,10740,0
2217,2020-04-30,동대문구,345825.8971,280705,21157,1473,19684,0
2218,2020-04-30,동작구,395384.4049,308086.25,15784,1570,14214,0
2219,2020-04-30,마포구,437281.8028,324565.8333,28401,2400,26001,0
2220,2020-04-30,서대문구,343228.9931,244753.75,15007,1489,13518,1
2221,2020-04-30,서초구,507393.3451,352835.4167,36373,2535,33838,0
2222,2020-04-30,성동구,323933.2966,238892.9167,17062,1322,15740,0
2223,2020-04-30,성북구,425378.0281,337544.1667,17151,1584,15567,0
2224,2020-04-30,송파구,724911.0327,498975,37428,3169,34259,0
2225,2020-04-30,양천구,397365.8291,326308.3333,18372,1663,16709,0
2226,2020-04-30,영등포구,407451.5741,341078.3333,27173,2259,24914,0
2227,2020-04-30,용산구,274065.131,199402.0833,18924,1183,17741,0
2228,2020-04-30,은평구,450557.3708,341654.1667,18350,1572,16778,0
2229,2020-04-30,종로구,248789.8663,183487.5,25318,1608,23710,0
2230,2020-04-30,중구,201573.5026,156564.5833,40015,2062,37953,0
2231,2020-04-30,중랑구,361840.7947,297242.5,16180,1286,14894,0
2232,2020-05-01,강남구,686789.5758,476896.6667,55675,4353,51322,0
2233,2020-05-01,강동구,488622.8268,319107.0833,20935,1897,19038,0
2234,2020-05-01,강북구,304239.1433,237800.8333,13461,1066,12395,0
2235,2020-05-01,강서구,513481.2786,418185,26009,2632,23377,0
2236,2020-05-01,관악구,473602.1406,384498.3333,19710,1903,17807,0
2237,2020-05-01,광진구,362789.5618,277931.6667,18984,1668,17316,0
2238,2020-05-01,구로구,358644.914,323758.75,22249,1798,20451,0
2239,2020-05-01,금천구,196975.2563,193591.6667,15627,1271,14356,0
2240,2020-05-01,노원구,516950.3413,391981.6667,18235,1866,16369,0
2241,2020-05-01,도봉구,279337.2841,239940.8333,11723,983,10740,0
2242,2020-05-01,동대문구,341742.0489,276527.9167,21157,1473,19684,0
2243,2020-05-01,동작구,383484.9919,297140.8333,15784,1570,14214,0
2244,2020-05-01,마포구,426187.9633,316082.0833,28401,2400,26001,0
2245,2020-05-01,서대문구,338020.2575,239467.9167,15007,1489,13518,0
2246,2020-05-01,서초구,502418.73,352762.0833,36373,2535,33838,0
2247,2020-05-01,성동구,316507.5049,233267.5,17062,1322,15740,1
2248,2020-05-01,성북구,415485.7073,328730.4167,17151,1584,15567,0
2249,2020-05-01,송파구,707667.0163,486537.0833,37428,3169,34259,0
2250,2020-05-01,양천구,390505.8815,318763.75,18372,1663,16709,0
2251,2020-05-01,영등포구,397813.615,332975,27173,2259,24914,0
2252,2020-05-01,용산구,268159.1232,195802.0833,18924,1183,17741,0
2253,2020-05-01,은평구,440549.9759,332547.0833,18350,1572,16778,0
2254,2020-05-01,종로구,247774.2062,184989.5833,25318,1608,23710,0
2255,2020-05-01,중구,207146.2297,162451.6667,40015,2062,37953,0
2256,2020-05-01,중랑구,356637.4075,290889.5833,16180,1286,14894,0
2257,2020-05-02,강남구,682627.0031,472228.3333,55675,4353,51322,0
2258,2020-05-02,강동구,488876.6348,321812.0833,20935,1897,19038,1
2259,2020-05-02,강북구,302940.4118,237179.5833,13461,1066,12395,0
2260,2020-05-02,강서구,511090.8915,417759.5833,26009,2632,23377,0
2261,2020-05-02,관악구,471356.7157,383030.4167,19710,1903,17807,0
2262,2020-05-02,광진구,361088.1894,276523.3333,18984,1668,17316,0
2263,2020-05-02,구로구,357322.781,323040,22249,1798,20451,0
2264,2020-05-02,금천구,193807.275,190195.8333,15627,1271,14356,0
2265,2020-05-02,노원구,517517.3058,393620,18235,1866,16369,0
2266,2020-05-02,도봉구,280493.2283,241586.25,11723,983,10740,0
2267,2020-05-02,동대문구,338157.6863,272804.1667,21157,1473,19684,0
2268,2020-05-02,동작구,382420.3615,297059.1667,15784,1570,14214,0
2269,2020-05-02,마포구,426465.5997,315352.5,28401,2400,26001,0
2270,2020-05-02,서대문구,333455.3914,237558.3333,15007,1489,13518,0
2271,2020-05-02,서초구,495747.8723,346616.6667,36373,2535,33838,0
2272,2020-05-02,성동구,312070.15,228772.5,17062,1322,15740,0
2273,2020-05-02,성북구,413449.9771,326929.1667,17151,1584,15567,0
2274,2020-05-02,송파구,701150.8173,482560.8333,37428,3169,34259,0
2275,2020-05-02,양천구,390016.6755,319058.75,18372,1663,16709,0
2276,2020-05-02,영등포구,394606.4441,328710.8333,27173,2259,24914,0
2277,2020-05-02,용산구,267450.5015,194653.75,18924,1183,17741,1
2278,2020-05-02,은평구,441006.2935,334137.5,18350,1572,16778,0
2279,2020-05-02,종로구,239080.4484,173767.0833,25318,1608,23710,0
2280,2020-05-02,중구,192459.9427,148032.0833,40015,2062,37953,0
2281,2020-05-02,중랑구,354742.3601,291080.8333,16180,1286,14894,0
2282,2020-05-03,강남구,652741.3372,446338.3333,55675,4353,51322,0
2283,2020-05-03,강동구,504358.7683,331437.5,20935,1897,19038,0
2284,2020-05-03,강북구,312131.2743,245108.75,13461,1066,12395,0
2285,2020-05-03,강서구,525792.7544,430149.1667,26009,2632,23377,0
2286,2020-05-03,관악구,487673.5061,397519.1667,19710,1903,17807,0
2287,2020-05-03,광진구,367746.6774,282813.3333,18984,1668,17316,0
2288,2020-05-03,구로구,368489.3396,333627.5,22249,1798,20451,0
2289,2020-05-03,금천구,199199.6186,196035,15627,1271,14356,0
2290,2020-05-03,노원구,531168.4947,407487.0833,18235,1866,16369,0
2291,2020-05-03,도봉구,290630.4126,252010,11723,983,10740,0
2292,2020-05-03,동대문구,343377.0472,277867.0833,21157,1473,19684,0
2293,2020-05-03,동작구,390353.148,304050.4167,15784,1570,14214,0
2294,2020-05-03,마포구,425787.4758,312936.6667,28401,2400,26001,0
2295,2020-05-03,서대문구,337811.7246,241131.6667,15007,1489,13518,0
2296,2020-05-03,서초구,485961.2786,336057.0833,36373,2535,33838,0
2297,2020-05-03,성동구,313035.9691,229399.1667,17062,1322,15740,0
2298,2020-05-03,성북구,425787.8179,337526.6667,17151,1584,15567,0
2299,2020-05-03,송파구,709926.4555,490479.1667,37428,3169,34259,0
2300,2020-05-03,양천구,400004.9994,330707.0833,18372,1663,16709,0
2301,2020-05-03,영등포구,399157.3813,332523.75,27173,2259,24914,0
2302,2020-05-03,용산구,267577.3817,193308.3333,18924,1183,17741,0
2303,2020-05-03,은평구,455959.249,347036.25,18350,1572,16778,0
2304,2020-05-03,종로구,225547.23,160966.6667,25318,1608,23710,0
2305,2020-05-03,중구,174823.415,132571.6667,40015,2062,37953,0
2306,2020-05-03,중랑구,366459.4344,301589.5833,16180,1286,14894,0
2307,2020-05-04,강남구,776693.0262,564685,55675,4353,51322,0
2308,2020-05-04,강동구,502459.585,327055.4167,20935,1897,19038,0
2309,2020-05-04,강북구,304602.3925,235189.5833,13461,1066,12395,0
2310,2020-05-04,강서구,532497.4601,434904.1667,26009,2632,23377,0
2311,2020-05-04,관악구,480346.5007,388229.5833,19710,1903,17807,0
2312,2020-05-04,광진구,370895.7049,283373.75,18984,1668,17316,0
2313,2020-05-04,구로구,381336.4904,347219.5833,22249,1798,20451,0
2314,2020-05-04,금천구,217448.1414,218766.25,15627,1271,14356,0
2315,2020-05-04,노원구,526279.0444,394373.75,18235,1866,16369,0
2316,2020-05-04,도봉구,279764.7132,237324.5833,11723,983,10740,0
2317,2020-05-04,동대문구,355367.8933,288550.4167,21157,1473,19684,0
2318,2020-05-04,동작구,396721.2192,308064.5833,15784,1570,14214,0
2319,2020-05-04,마포구,450326.5537,338902.0833,28401,2400,26001,0
2320,2020-05-04,서대문구,359940.4846,250989.1667,15007,1489,13518,0
2321,2020-05-04,서초구,561304.3308,403069.5833,36373,2535,33838,0
2322,2020-05-04,성동구,339515.1509,255179.1667,17062,1322,15740,0
2323,2020-05-04,성북구,426262.4131,334991.6667,17151,1584,15567,0
2324,2020-05-04,송파구,739239.8644,510101.25,37428,3169,34259,0
2325,2020-05-04,양천구,399245.7008,322918.75,18372,1663,16709,0
2326,2020-05-04,영등포구,453816.7937,392890.8333,27173,2259,24914,0
2327,2020-05-04,용산구,284249.2512,209575.4167,18924,1183,17741,0
2328,2020-05-04,은평구,444136.3548,330662.0833,18350,1572,16778,0
2329,2020-05-04,종로구,275341.7024,217598.3333,25318,1608,23710,0
2330,2020-05-04,중구,257689.8048,223852.9167,40015,2062,37953,0
2331,2020-05-04,중랑구,357537.4776,290451.6667,16180,1286,14894,0
2332,2020-05-05,강남구,686115.1252,471382.0833,55675,4353,51322,0
2333,2020-05-05,강동구,515404.3782,340202.0833,20935,1897,19038,0
2334,2020-05-05,강북구,315834.1604,247858.3333,13461,1066,12395,0
2335,2020-05-05,강서구,544140.7007,444908.3333,26009,2632,23377,0
2336,2020-05-05,관악구,505222.2549,414435.8333,19710,1903,17807,0
2337,2020-05-05,광진구,384855.1137,296088.3333,18984,1668,17316,0
2338,2020-05-05,구로구,377696.1473,345005,22249,1798,20451,0
2339,2020-05-05,금천구,207084.8467,204760.8333,15627,1271,14356,0
2340,2020-05-05,노원구,542084.0697,415386.25,18235,1866,16369,0
2341,2020-05-05,도봉구,291826.0763,252355,11723,983,10740,0
2342,2020-05-05,동대문구,354457.2594,289817.0833,21157,1473,19684,0
2343,2020-05-05,동작구,408054.915,319001.6667,15784,1570,14214,0
2344,2020-05-05,마포구,443438.5188,328030.4167,28401,2400,26001,0
2345,2020-05-05,서대문구,349888.9651,250155.4167,15007,1489,13518,0
2346,2020-05-05,서초구,508654.9244,352125.8333,36373,2535,33838,0
2347,2020-05-05,성동구,331373.5149,244642.0833,17062,1322,15740,0
2348,2020-05-05,성북구,437042.4297,348479.5833,17151,1584,15567,0
2349,2020-05-05,송파구,747292.1926,516025,37428,3169,34259,0
2350,2020-05-05,양천구,410246.0405,339449.1667,18372,1663,16709,0
2351,2020-05-05,영등포구,419333.884,351654.1667,27173,2259,24914,0
2352,2020-05-05,용산구,274178.2592,199959.5833,18924,1183,17741,0
2353,2020-05-05,은평구,464769.3168,353633.3333,18350,1572,16778,0
2354,2020-05-05,종로구,242581.3747,175961.6667,25318,1608,23710,0
2355,2020-05-05,중구,198682.2806,151953.3333,40015,2062,37953,0
2356,2020-05-05,중랑구,371404.5924,307069.5833,16180,1286,14894,0
2357,2020-05-06,강남구,871147.8779,647122.5,55675,4353,51322,0
2358,2020-05-06,강동구,506529.4945,327490.8333,20935,1897,19038,0
2359,2020-05-06,강북구,300631.7852,231430.8333,13461,1066,12395,0
2360,2020-05-06,강서구,541150.7487,438962.0833,26009,2632,23377,0
2361,2020-05-06,관악구,481294.5254,385776.6667,19710,1903,17807,0
2362,2020-05-06,광진구,371133.6962,281405,18984,1668,17316,0
2363,2020-05-06,구로구,394976.1471,358331.6667,22249,1798,20451,0
2364,2020-05-06,금천구,236148.1513,239459.5833,15627,1271,14356,0
2365,2020-05-06,노원구,523465.11,388094.5833,18235,1866,16369,0
2366,2020-05-06,도봉구,277864.235,232844.5833,11723,983,10740,0
2367,2020-05-06,동대문구,359612.8443,291038.3333,21157,1473,19684,0
2368,2020-05-06,동작구,401185.4529,309751.6667,15784,1570,14214,0
2369,2020-05-06,마포구,464882.623,349327.5,28401,2400,26001,0
2370,2020-05-06,서대문구,370678.5041,254261.6667,15007,1489,13518,0
2371,2020-05-06,서초구,605810.4847,441899.1667,36373,2535,33838,0
2372,2020-05-06,성동구,351474.6226,265551.6667,17062,1322,15740,0
2373,2020-05-06,성북구,427738.0197,334221.6667,17151,1584,15567,0
2374,2020-05-06,송파구,758282.1532,524384.1667,37428,3169,34259,0
2375,2020-05-06,양천구,401456.9408,320520.4167,18372,1663,16709,0
2376,2020-05-06,영등포구,482155.2889,419142.5,27173,2259,24914,0
2377,2020-05-06,용산구,295762.6917,219917.9167,18924,1183,17741,0
2378,2020-05-06,은평구,439592.4479,324139.5833,18350,1572,16778,0
2379,2020-05-06,종로구,300417.9231,244443.75,25318,1608,23710,0
2380,2020-05-06,중구,286625.3246,260441.6667,40015,2062,37953,0
2381,2020-05-06,중랑구,354702.1008,286078.75,16180,1286,14894,0
2382,2020-05-07,강남구,879688.8918,650717.9167,55675,4353,51322,0
2383,2020-05-07,강동구,503954.6719,325717.9167,20935,1897,19038,0
2384,2020-05-07,강북구,299821.4396,230666.6667,13461,1066,12395,0
2385,2020-05-07,강서구,540116.7626,437481.25,26009,2632,23377,0
2386,2020-05-07,관악구,480199.1715,384755.8333,19710,1903,17807,0
2387,2020-05-07,광진구,370398.205,280990.4167,18984,1668,17316,0
2388,2020-05-07,구로구,394166.3959,356964.1667,22249,1798,20451,0
2389,2020-05-07,금천구,235366.8645,238214.5833,15627,1271,14356,0
2390,2020-05-07,노원구,521708.4349,386593.3333,18235,1866,16369,0
2391,2020-05-07,도봉구,276520.5551,231630,11723,983,10740,0
2392,2020-05-07,동대문구,359451.7291,290416.25,21157,1473,19684,0
2393,2020-05-07,동작구,400202.2396,308942.0833,15784,1570,14214,0
2394,2020-05-07,마포구,467897.7148,351090.8333,28401,2400,26001,0
2395,2020-05-07,서대문구,372526.3679,254844.1667,15007,1489,13518,0
2396,2020-05-07,서초구,613598.7567,445837.9167,36373,2535,33838,0
2397,2020-05-07,성동구,352109.1495,265430,17062,1322,15740,0
2398,2020-05-07,성북구,426559.673,332527.5,17151,1584,15567,0
2399,2020-05-07,송파구,758852.807,524008.3333,37428,3169,34259,0
2400,2020-05-07,양천구,400412.3235,318785.8333,18372,1663,16709,0
2401,2020-05-07,영등포구,483844.0108,419187.9167,27173,2259,24914,0
2402,2020-05-07,용산구,296917.4062,220298.75,18924,1183,17741,0
2403,2020-05-07,은평구,437811.6395,323318.75,18350,1572,16778,0
2404,2020-05-07,종로구,303281.3696,245881.6667,25318,1608,23710,0
2405,2020-05-07,중구,291503.0804,262136.25,40015,2062,37953,0
2406,2020-05-07,중랑구,353174.5269,284824.5833,16180,1286,14894,0
2407,2020-05-08,강남구,870416.3315,642770.4167,55675,4353,51322,0
2408,2020-05-08,강동구,505442.9807,327848.75,20935,1897,19038,1
2409,2020-05-08,강북구,300328.5429,230967.0833,13461,1066,12395,0
2410,2020-05-08,강서구,539100.6842,436915,26009,2632,23377,0
2411,2020-05-08,관악구,478319.4189,382950,19710,1903,17807,3
2412,2020-05-08,광진구,370502.4805,280379.1667,18984,1668,17316,0
2413,2020-05-08,구로구,392369.863,356507.9167,22249,1798,20451,0
2414,2020-05-08,금천구,234306.9929,236383.3333,15627,1271,14356,0
2415,2020-05-08,노원구,521104.591,387888.3333,18235,1866,16369,0
2416,2020-05-08,도봉구,278215.9954,232860,11723,983,10740,0
2417,2020-05-08,동대문구,358521.2398,289728.3333,21157,1473,19684,0
2418,2020-05-08,동작구,399413.8097,309845.8333,15784,1570,14214,1
2419,2020-05-08,마포구,465650.0567,349842.0833,28401,2400,26001,0
2420,2020-05-08,서대문구,369357.8928,252693.3333,15007,1489,13518,0
2421,2020-05-08,서초구,611696.0969,445111.25,36373,2535,33838,0
2422,2020-05-08,성동구,352491.895,264191.6667,17062,1322,15740,0
2423,2020-05-08,성북구,425369.9051,331892.5,17151,1584,15567,0
2424,2020-05-08,송파구,758103.5248,523898.3333,37428,3169,34259,0
2425,2020-05-08,양천구,400794.756,320351.6667,18372,1663,16709,0
2426,2020-05-08,영등포구,480087.7604,414375.4167,27173,2259,24914,0
2427,2020-05-08,용산구,297103.3531,218947.9167,18924,1183,17741,4
2428,2020-05-08,은평구,438296.8837,323557.5,18350,1572,16778,0
2429,2020-05-08,종로구,296337.6419,238600,25318,1608,23710,1
2430,2020-05-08,중구,285433.9852,253658.75,40015,2062,37953,1
2431,2020-05-08,중랑구,354920.3813,285700.8333,16180,1286,14894,2
2432,2020-05-09,강남구,741240.0891,518227.5,55675,4353,51322,1
2433,2020-05-09,강동구,522399.4191,343601.6667,20935,1897,19038,0
2434,2020-05-09,강북구,316888.4466,249217.5,13461,1066,12395,0
2435,2020-05-09,강서구,548760.4068,447306.6667,26009,2632,23377,2
2436,2020-05-09,관악구,504212.1704,410295,19710,1903,17807,1
2437,2020-05-09,광진구,380267.6033,292940.8333,18984,1668,17316,2
2438,2020-05-09,구로구,386375.2743,352745.4167,22249,1798,20451,0
2439,2020-05-09,금천구,210151.3359,206153.75,15627,1271,14356,0
2440,2020-05-09,노원구,546193.4369,417544.5833,18235,1866,16369,0
2441,2020-05-09,도봉구,292391.3597,252147.9167,11723,983,10740,1
2442,2020-05-09,동대문구,357172.9869,290353.3333,21157,1473,19684,0
2443,2020-05-09,동작구,409542.217,318535.4167,15784,1570,14214,2
2444,2020-05-09,마포구,447575.4723,332361.25,28401,2400,26001,0
2445,2020-05-09,서대문구,352996.6286,250963.3333,15007,1489,13518,1
2446,2020-05-09,서초구,542884.4399,378273.3333,36373,2535,33838,1
2447,2020-05-09,성동구,333518.765,244629.5833,17062,1322,15740,0
2448,2020-05-09,성북구,439546.6142,347500.8333,17151,1584,15567,2
2449,2020-05-09,송파구,751001.2049,519995,37428,3169,34259,1
2450,2020-05-09,양천구,417598.7131,344285,18372,1663,16709,0
2451,2020-05-09,영등포구,424771.5393,358332.5,27173,2259,24914,0
2452,2020-05-09,용산구,272901.6461,198495.8333,18924,1183,17741,4
2453,2020-05-09,은평구,466994.2642,352841.6667,18350,1572,16778,0
2454,2020-05-09,종로구,238453.5307,174466.6667,25318,1608,23710,0
2455,2020-05-09,중구,196777.7806,153106.6667,40015,2062,37953,0
2456,2020-05-09,중랑구,374710.5267,307500,16180,1286,14894,0
2457,2020-05-10,강남구,686309.2273,471532.9167,55675,4353,51322,4
2458,2020-05-10,강동구,523869.6251,343742.5,20935,1897,19038,0
2459,2020-05-10,강북구,320394.1727,252627.0833,13461,1066,12395,1
2460,2020-05-10,강서구,548225.9741,446898.3333,26009,2632,23377,1
2461,2020-05-10,관악구,512388.044,418778.75,19710,1903,17807,3
2462,2020-05-10,광진구,381719.7394,294111.6667,18984,1668,17316,1
2463,2020-05-10,구로구,385333.3038,351313.75,22249,1798,20451,0
2464,2020-05-10,금천구,207121.8085,203732.0833,15627,1271,14356,0
2465,2020-05-10,노원구,549053.7936,419847.5,18235,1866,16369,0
2466,2020-05-10,도봉구,297160.1773,257729.5833,11723,983,10740,0
2467,2020-05-10,동대문구,355715.0426,288270.8333,21157,1473,19684,1
2468,2020-05-10,동작구,408253.7152,318938.3333,15784,1570,14214,2
2469,2020-05-10,마포구,441558.5754,324880.8333,28401,2400,26001,0
2470,2020-05-10,서대문구,350183.5785,250355.4167,15007,1489,13518,0
2471,2020-05-10,서초구,512893.4706,352976.6667,36373,2535,33838,0
2472,2020-05-10,성동구,328110.7017,239432.9167,17062,1322,15740,0
2473,2020-05-10,성북구,443699.9863,350440,17151,1584,15567,1
2474,2020-05-10,송파구,742776.1838,512573.75,37428,3169,34259,1
2475,2020-05-10,양천구,417616.9583,345305.8333,18372,1663,16709,1
2476,2020-05-10,영등포구,415336.7005,347820.8333,27173,2259,24914,0
2477,2020-05-10,용산구,267524.8171,194024.5833,18924,1183,17741,2
2478,2020-05-10,은평구,473495.5269,358375.8333,18350,1572,16778,0
2479,2020-05-10,종로구,229283.6964,164651.6667,25318,1608,23710,0
2480,2020-05-10,중구,178344.8434,135654.5833,40015,2062,37953,0
2481,2020-05-10,중랑구,376771.3987,309998.75,16180,1286,14894,1
2482,2020-05-10,중랑구,376771.3987,309998.75,16180,1286,14894,1
2483,2020-05-11,강남구,862853.507,639378.3333,55675,4353,51322,0
2484,2020-05-11,강동구,508636.5272,327924.5833,20935,1897,19038,1
2485,2020-05-11,강북구,302080.6033,232617.9167,13461,1066,12395,1
2486,2020-05-11,강서구,543676.0879,439242.9167,26009,2632,23377,1
2487,2020-05-11,관악구,482374.3594,387856.6667,19710,1903,17807,1
2488,2020-05-11,광진구,371202.6047,281060.8333,18984,1668,17316,0
2489,2020-05-11,구로구,396165.8645,359560.4167,22249,1798,20451,0
2490,2020-05-11,금천구,236297.2439,240430.8333,15627,1271,14356,0
2491,2020-05-11,노원구,524315.2077,388827.5,18235,1866,16369,0
2492,2020-05-11,도봉구,279442.2102,233563.3333,11723,983,10740,1
2493,2020-05-11,동대문구,360899.044,292445.8333,21157,1473,19684,0
2494,2020-05-11,동작구,401312.8382,310808.75,15784,1570,14214,0
2495,2020-05-11,마포구,463573.5358,347887.9167,28401,2400,26001,0
2496,2020-05-11,서대문구,370165.0184,253547.9167,15007,1489,13518,1
2497,2020-05-11,서초구,606486.8519,440887.5,36373,2535,33838,1
2498,2020-05-11,성동구,351354.4508,263382.0833,17062,1322,15740,1
2499,2020-05-11,성북구,430595.9749,335782.9167,17151,1584,15567,0
2500,2020-05-11,송파구,756672.8657,524437.5,37428,3169,34259,0
2501,2020-05-11,양천구,401613.9376,321032.9167,18372,1663,16709,1
2502,2020-05-11,영등포구,478476.5795,415582.5,27173,2259,24914,0
2503,2020-05-11,용산구,290581.9333,215522.9167,18924,1183,17741,2
2504,2020-05-11,은평구,444279.2816,325903.75,18350,1572,16778,0
2505,2020-05-11,종로구,294460.1849,239512.9167,25318,1608,23710,0
2506,2020-05-11,중구,283756.386,255707.0833,40015,2062,37953,1
2507,2020-05-11,중랑구,356659.9785,287663.75,16180,1286,14894,0
2508,2020-05-12,강남구,872171.6686,641933.75,55675,4353,51322,0
2509,2020-05-12,강동구,507999.5172,327375,20935,1897,19038,0
2510,2020-05-12,강북구,298280.0137,231656.25,13461,1066,12395,1
2511,2020-05-12,강서구,543433.4297,437592.5,26009,2632,23377,0
2512,2020-05-12,관악구,482426.1788,386578.3333,19710,1903,17807,1
2513,2020-05-12,광진구,369774.4481,279951.6667,18984,1668,17316,0
2514,2020-05-12,구로구,393933.754,357500,22249,1798,20451,0
2515,2020-05-12,금천구,235383.6364,238351.25,15627,1271,14356,0
2516,2020-05-12,노원구,524483.0893,387577.0833,18235,1866,16369,1
2517,2020-05-12,도봉구,277561.623,232670.4167,11723,983,10740,1
2518,2020-05-12,동대문구,361201.9798,292012.0833,21157,1473,19684,1
2519,2020-05-12,동작구,400378.7926,310556.25,15784,1570,14214,1
2520,2020-05-12,마포구,464949.9318,348010.8333,28401,2400,26001,0
2521,2020-05-12,서대문구,372134.8348,254480.4167,15007,1489,13518,0
2522,2020-05-12,서초구,609669.4335,441135.8333,36373,2535,33838,0
2523,2020-05-12,성동구,352750.9043,265150.4167,17062,1322,15740,1
2524,2020-05-12,성북구,431961.9892,335606.25,17151,1584,15567,0
2525,2020-05-12,송파구,757386.3136,523781.6667,37428,3169,34259,1
2526,2020-05-12,양천구,400241.2005,319723.3333,18372,1663,16709,0
2527,2020-05-12,영등포구,480631.4857,414288.75,27173,2259,24914,0
2528,2020-05-12,용산구,291565.1001,215577.5,18924,1183,17741,0
2529,2020-05-12,은평구,442791.719,324959.1667,18350,1572,16778,0
2530,2020-05-12,종로구,299056.6204,242047.0833,25318,1608,23710,0
2531,2020-05-12,중구,287273.0964,256407.0833,40015,2062,37953,0
2532,2020-05-12,중랑구,354897.0428,286072.9167,16180,1286,14894,0
2533,2020-05-13,강남구,873362.2749,641290,55675,4353,51322,0
2534,2020-05-13,강동구,507687.3225,327126.6667,20935,1897,19038,1
2535,2020-05-13,강북구,301284.506,230932.0833,13461,1066,12395,0
2536,2020-05-13,강서구,541670.547,436529.1667,26009,2632,23377,1
2537,2020-05-13,관악구,482628.4898,386690.4167,19710,1903,17807,0
2538,2020-05-13,광진구,370797.3935,280459.5833,18984,1668,17316,0
2539,2020-05-13,구로구,394385.0283,356732.5,22249,1798,20451,0
2540,2020-05-13,금천구,235457.4387,237582.5,15627,1271,14356,0
2541,2020-05-13,노원구,522887.7083,386760.4167,18235,1866,16369,1
2542,2020-05-13,도봉구,277890.8277,232381.25,11723,983,10740,0
2543,2020-05-13,동대문구,361367.2464,291949.5833,21157,1473,19684,0
2544,2020-05-13,동작구,400309.0768,310324.5833,15784,1570,14214,0
2545,2020-05-13,마포구,464787.9096,347840.8333,28401,2400,26001,0
2546,2020-05-13,서대문구,371365.6503,254210.4167,15007,1489,13518,0
2547,2020-05-13,서초구,610928.9173,441025.8333,36373,2535,33838,0
2548,2020-05-13,성동구,353781.329,265062.5,17062,1322,15740,0
2549,2020-05-13,성북구,432101.6977,335263.3333,17151,1584,15567,0
2550,2020-05-13,송파구,758323.2455,523697.0833,37428,3169,34259,1
2551,2020-05-13,양천구,400641.0842,319418.3333,18372,1663,16709,0
2552,2020-05-13,영등포구,482026.4576,414806.6667,27173,2259,24914,1
2553,2020-05-13,용산구,291663.7111,214777.9167,18924,1183,17741,0
2554,2020-05-13,은평구,441890.4935,324074.1667,18350,1572,16778,0
2555,2020-05-13,종로구,301085.7481,242897.5,25318,1608,23710,0
2556,2020-05-13,중구,287619.4184,255569.5833,40015,2062,37953,0
2557,2020-05-13,중랑구,353580.2387,284912.5,16180,1286,14894,0
2558,2020-05-14,강남구,869763.891,638956.25,55675,4353,51322,1
2559,2020-05-14,강동구,505363.4958,325555.4167,20935,1897,19038,2
2560,2020-05-14,강북구,301046.9399,231166.6667,13461,1066,12395,0
2561,2020-05-14,강서구,541729.6707,436922.5,26009,2632,23377,0
2562,2020-05-14,관악구,482144.1268,386835,19710,1903,17807,0
2563,2020-05-14,광진구,371031.374,280845,18984,1668,17316,1
2564,2020-05-14,구로구,394142.5224,355936.6667,22249,1798,20451,0
2565,2020-05-14,금천구,234955.5374,237092.0833,15627,1271,14356,1
2566,2020-05-14,노원구,522357.5791,386397.0833,18235,1866,16369,0
2567,2020-05-14,도봉구,278135.3538,232290.8333,11723,983,10740,2
2568,2020-05-14,동대문구,361185.1118,291540,21157,1473,19684,1
2569,2020-05-14,동작구,400521.1253,310367.5,15784,1570,14214,0
2570,2020-05-14,마포구,462844.2329,347046.25,28401,2400,26001,0
2571,2020-05-14,서대문구,371439.7071,253897.9167,15007,1489,13518,0
2572,2020-05-14,서초구,610012.293,440072.9167,36373,2535,33838,0
2573,2020-05-14,성동구,353885.8497,264767.5,17062,1322,15740,0
2574,2020-05-14,성북구,431950.5495,335080,17151,1584,15567,0
2575,2020-05-14,송파구,756572.7996,522612.5,37428,3169,34259,1
2576,2020-05-14,양천구,400148.0165,319327.0833,18372,1663,16709,0
2577,2020-05-14,영등포구,481068.2346,414140.8333,27173,2259,24914,1
2578,2020-05-14,용산구,291660.7525,214809.1667,18924,1183,17741,2
2579,2020-05-14,은평구,441651.9526,323916.25,18350,1572,16778,0
2580,2020-05-14,종로구,299733.8412,242130.4167,25318,1608,23710,0
2581,2020-05-14,중구,287133.4193,255072.5,40015,2062,37953,0
2582,2020-05-14,중랑구,354246.7185,285179.1667,16180,1286,14894,0
2583,2020-05-15,강남구,866071.9712,637178.75,55675,4353,51322,1
2584,2020-05-15,강동구,511148.3176,330072.0833,20935,1897,19038,0
2585,2020-05-15,강북구,303937.8291,234389.1667,13461,1066,12395,0
2586,2020-05-15,강서구,543776.6414,440372.9167,26009,2632,23377,0
2587,2020-05-15,관악구,486217.4583,390796.6667,19710,1903,17807,1
2588,2020-05-15,광진구,373520.1364,284084.1667,18984,1668,17316,0
2589,2020-05-15,구로구,397067.4611,358812.0833,22249,1798,20451,0
2590,2020-05-15,금천구,234303.4803,236408.75,15627,1271,14356,0
2591,2020-05-15,노원구,526609.2491,390863.3333,18235,1866,16369,0
2592,2020-05-15,도봉구,279358.3823,233908.75,11723,983,10740,0
2593,2020-05-15,동대문구,361482.5509,292859.5833,21157,1473,19684,0
2594,2020-05-15,동작구,402455.5396,313107.9167,15784,1570,14214,0
2595,2020-05-15,마포구,460699.4708,345377.0833,28401,2400,26001,0
2596,2020-05-15,서대문구,369824.0085,254244.5833,15007,1489,13518,1
2597,2020-05-15,서초구,608713.367,440408.3333,36373,2535,33838,0
2598,2020-05-15,성동구,353471.7077,263758.3333,17062,1322,15740,0
2599,2020-05-15,성북구,433446.7058,336794.1667,17151,1584,15567,0
2600,2020-05-15,송파구,759780.1601,526944.5833,37428,3169,34259,0
2601,2020-05-15,양천구,403146.5051,323439.5833,18372,1663,16709,0
2602,2020-05-15,영등포구,479335.1401,412896.25,27173,2259,24914,0
2603,2020-05-15,용산구,290905.7889,214603.3333,18924,1183,17741,1
2604,2020-05-15,은평구,446005.3291,328059.1667,18350,1572,16778,2
2605,2020-05-15,종로구,291654.2401,235890,25318,1608,23710,0
2606,2020-05-15,중구,279645.6269,245609.5833,40015,2062,37953,0
2607,2020-05-15,중랑구,357459.4685,288675.4167,16180,1286,14894,0
2608,2020-05-16,강남구,739930.7141,513287.5,55675,4353,51322,0
2609,2020-05-16,강동구,519423.1635,340808.3333,20935,1897,19038,0
2610,2020-05-16,강북구,315389.2875,246109.5833,13461,1066,12395,0
2611,2020-05-16,강서구,545371.5509,443977.9167,26009,2632,23377,0
2612,2020-05-16,관악구,505911.612,410898.3333,19710,1903,17807,0
2613,2020-05-16,광진구,381574.4375,293912.5,18984,1668,17316,0
2614,2020-05-16,구로구,384968.2068,348425.4167,22249,1798,20451,0
2615,2020-05-16,금천구,207553.1241,204032.9167,15627,1271,14356,0
2616,2020-05-16,노원구,543448.0498,412517.0833,18235,1866,16369,2
2617,2020-05-16,도봉구,290578.2902,248135,11723,983,10740,0
2618,2020-05-16,동대문구,357970.5233,289757.0833,21157,1473,19684,0
2619,2020-05-16,동작구,408495.689,320395.8333,15784,1570,14214,0
2620,2020-05-16,마포구,441659.7953,327114.5833,28401,2400,26001,0
2621,2020-05-16,서대문구,351339.1361,249645.8333,15007,1489,13518,0
2622,2020-05-16,서초구,541203.2865,376196.6667,36373,2535,33838,0
2623,2020-05-16,성동구,337027.7582,246867.5,17062,1322,15740,0
2624,2020-05-16,성북구,437084.8118,344427.9167,17151,1584,15567,0
2625,2020-05-16,송파구,752079.4539,518736.6667,37428,3169,34259,2
2626,2020-05-16,양천구,415160.4093,339655,18372,1663,16709,0
2627,2020-05-16,영등포구,426600.1546,356440.4167,27173,2259,24914,0
2628,2020-05-16,용산구,270023.8148,196020,18924,1183,17741,0
2629,2020-05-16,은평구,466581.6019,350465.4167,18350,1572,16778,0
2630,2020-05-16,종로구,245298.015,180237.0833,25318,1608,23710,0
2631,2020-05-16,중구,201762.7293,157122.5,40015,2062,37953,0
2632,2020-05-16,중랑구,369976.1592,302722.0833,16180,1286,14894,0
2633,2020-05-17,강남구,686130.4816,469287.0833,55675,4353,51322,0
2634,2020-05-17,강동구,521887.136,341711.25,20935,1897,19038,0
2635,2020-05-17,강북구,317757.973,250047.9167,13461,1066,12395,0
2636,2020-05-17,강서구,545675.3684,444611.25,26009,2632,23377,0
2637,2020-05-17,관악구,512640.383,417900.8333,19710,1903,17807,0
2638,2020-05-17,광진구,382610.196,294362.5,18984,1668,17316,0
2639,2020-05-17,구로구,385742.7604,349330.8333,22249,1798,20451,0
2640,2020-05-17,금천구,206298.2907,203690,15627,1271,14356,0
2641,2020-05-17,노원구,548433.8995,419143.3333,18235,1866,16369,0
2642,2020-05-17,도봉구,297463.9015,255517.0833,11723,983,10740,0
2643,2020-05-17,동대문구,355308.9884,287920,21157,1473,19684,0
2644,2020-05-17,동작구,406599.186,317652.0833,15784,1570,14214,0
2645,2020-05-17,마포구,434602.2159,320080.8333,28401,2400,26001,0
2646,2020-05-17,서대문구,347940.2628,248270,15007,1489,13518,0
2647,2020-05-17,서초구,513291.6276,352777.0833,36373,2535,33838,0
2648,2020-05-17,성동구,328177.9389,239890.4167,17062,1322,15740,0
2649,2020-05-17,성북구,442190.0492,347897.0833,17151,1584,15567,0
2650,2020-05-17,송파구,742470.8542,512337.9167,37428,3169,34259,0
2651,2020-05-17,양천구,417692.0283,343527.5,18372,1663,16709,0
2652,2020-05-17,영등포구,419586.1276,349492.5,27173,2259,24914,0
2653,2020-05-17,용산구,265660.309,192016.25,18924,1183,17741,0
2654,2020-05-17,은평구,472309.5762,357076.6667,18350,1572,16778,0
2655,2020-05-17,종로구,230015.9077,164936.6667,25318,1608,23710,1
2656,2020-05-17,중구,180740.0777,136803.3333,40015,2062,37953,0
2657,2020-05-17,중랑구,374715.8599,307754.1667,16180,1286,14894,0
2658,2020-05-18,강남구,856748.7849,632328.3333,55675,4353,51322,0
2659,2020-05-18,강동구,510677.4198,328779.1667,20935,1897,19038,0
2660,2020-05-18,강북구,303606.3241,233437.9167,13461,1066,12395,0
2661,2020-05-18,강서구,545473.901,440635.8333,26009,2632,23377,1
2662,2020-05-18,관악구,484755.3659,389083.3333,19710,1903,17807,0
2663,2020-05-18,광진구,372161.7366,281001.6667,18984,1668,17316,0
2664,2020-05-18,구로구,398555.0877,360212.5,22249,1798,20451,1
2665,2020-05-18,금천구,236640.6208,240222.9167,15627,1271,14356,0
2666,2020-05-18,노원구,526772.577,390617.9167,18235,1866,16369,0
2667,2020-05-18,도봉구,280551.5647,235089.1667,11723,983,10740,0
2668,2020-05-18,동대문구,362330.8622,293239.5833,21157,1473,19684,0
2669,2020-05-18,동작구,402633.7096,311922.9167,15784,1570,14214,0
2670,2020-05-18,마포구,457320.1154,342600.8333,28401,2400,26001,0
2671,2020-05-18,서대문구,370285.4941,253384.1667,15007,1489,13518,0
2672,2020-05-18,서초구,602728.9404,436693.3333,36373,2535,33838,0
2673,2020-05-18,성동구,351851.7493,264045,17062,1322,15740,0
2674,2020-05-18,성북구,434441.8018,337014.1667,17151,1584,15567,1
2675,2020-05-18,송파구,756430.1366,523701.25,37428,3169,34259,1
2676,2020-05-18,양천구,402977.9416,321410.4167,18372,1663,16709,2
2677,2020-05-18,영등포구,477983.3967,413208.3333,27173,2259,24914,1
2678,2020-05-18,용산구,287812.0564,213221.6667,18924,1183,17741,0
2679,2020-05-18,은평구,446310.874,328113.3333,18350,1572,16778,0
2680,2020-05-18,종로구,291265.3162,235516.25,25318,1608,23710,0
2681,2020-05-18,중구,278825.568,247507.5,40015,2062,37953,0
2682,2020-05-18,중랑구,358408.064,289263.3333,16180,1286,14894,0
2683,2020-05-19,강남구,866455.0765,637887.9167,55675,4353,51322,1
2684,2020-05-19,강동구,509741.5115,327868.3333,20935,1897,19038,1
2685,2020-05-19,강북구,303712.6619,233452.9167,13461,1066,12395,1
2686,2020-05-19,강서구,544462.3296,439340.4167,26009,2632,23377,0
2687,2020-05-19,관악구,484616.0489,388412.9167,19710,1903,17807,0
2688,2020-05-19,광진구,371055.7451,281102.5,18984,1668,17316,0
2689,2020-05-19,구로구,399280.4064,358600,22249,1798,20451,0
2690,2020-05-19,금천구,239721.9885,239184.5833,15627,1271,14356,0
2691,2020-05-19,노원구,526267.3972,390073.3333,18235,1866,16369,0
2692,2020-05-19,도봉구,279915.18,233502.5,11723,983,10740,1
2693,2020-05-19,동대문구,362350.5624,292803.75,21157,1473,19684,0
2694,2020-05-19,동작구,402080.7898,311977.5,15784,1570,14214,0
2695,2020-05-19,마포구,460862.4459,343892.9167,28401,2400,26001,0
2696,2020-05-19,서대문구,372038.6769,253420,15007,1489,13518,0
2697,2020-05-19,서초구,607038.6005,438412.9167,36373,2535,33838,1
2698,2020-05-19,성동구,352594.0741,264143.3333,17062,1322,15740,0
2699,2020-05-19,성북구,434178.9199,336620.4167,17151,1584,15567,0
2700,2020-05-19,송파구,758872.3198,524766.6667,37428,3169,34259,0
2701,2020-05-19,양천구,403195.5651,321209.5833,18372,1663,16709,0
2702,2020-05-19,영등포구,480319.2344,413371.25,27173,2259,24914,0
2703,2020-05-19,용산구,288798.2364,213480.8333,18924,1183,17741,4
2704,2020-05-19,은평구,443679.1466,326672.0833,18350,1572,16778,0
2705,2020-05-19,종로구,297482.0339,240171.25,25318,1608,23710,0
2706,2020-05-19,중구,284596.9185,250867.9167,40015,2062,37953,0
2707,2020-05-19,중랑구,357841.147,288389.1667,16180,1286,14894,0
2708,2020-05-20,강남구,865730.877,637727.0833,55675,4353,51322,0
2709,2020-05-20,강동구,506143.9405,326231.25,20935,1897,19038,0
2710,2020-05-20,강북구,299927.8742,229770,13461,1066,12395,0
2711,2020-05-20,강서구,542239.6575,436832.0833,26009,2632,23377,0
2712,2020-05-20,관악구,480839.0709,385680,19710,1903,17807,0
2713,2020-05-20,광진구,369225.597,279607.0833,18984,1668,17316,0
2714,2020-05-20,구로구,393735.8207,355188.3333,22249,1798,20451,0
2715,2020-05-20,금천구,235423.1466,237180,15627,1271,14356,0
2716,2020-05-20,노원구,522667.425,386430.4167,18235,1866,16369,0
2717,2020-05-20,도봉구,278332.3561,231534.5833,11723,983,10740,1
2718,2020-05-20,동대문구,362251.3731,292558.75,21157,1473,19684,0
2719,2020-05-20,동작구,399460.5052,310874.1667,15784,1570,14214,1
2720,2020-05-20,마포구,463071.439,346172.0833,28401,2400,26001,0
2721,2020-05-20,서대문구,370717.1511,253019.1667,15007,1489,13518,0
2722,2020-05-20,서초구,608597.0826,440226.6667,36373,2535,33838,0
2723,2020-05-20,성동구,352219.3439,264803.75,17062,1322,15740,0
2724,2020-05-20,성북구,431439.9494,335312.0833,17151,1584,15567,0
2725,2020-05-20,송파구,756774.6397,522247.5,37428,3169,34259,0
2726,2020-05-20,양천구,399040.6075,318538.3333,18372,1663,16709,1
2727,2020-05-20,영등포구,480871.1025,414266.6667,27173,2259,24914,0
2728,2020-05-20,용산구,290680.9208,215202.5,18924,1183,17741,0
2729,2020-05-20,은평구,441104.3983,323332.9167,18350,1572,16778,0
2730,2020-05-20,종로구,303766.7525,245082.9167,25318,1608,23710,0
2731,2020-05-20,중구,289275.4287,254024.1667,40015,2062,37953,0
2732,2020-05-20,중랑구,353405.8734,285187.0833,16180,1286,14894,1
2733,2020-05-21,강남구,863418.9442,602860.8333,55675,4353,51322,0
2734,2020-05-21,강동구,504694.2711,312727.0833,20935,1897,19038,0
2735,2020-05-21,강북구,298700.5174,220815,13461,1066,12395,0
2736,2020-05-21,강서구,541066.3893,418723.75,26009,2632,23377,0
2737,2020-05-21,관악구,478229.8304,370493.3333,19710,1903,17807,1
2738,2020-05-21,광진구,367770.8611,268821.25,18984,1668,17316,1
2739,2020-05-21,구로구,392111.9528,339526.25,22249,1798,20451,0
2740,2020-05-21,금천구,232726.4024,225056.25,15627,1271,14356,0
2741,2020-05-21,노원구,520266.187,372028.3333,18235,1866,16369,1
2742,2020-05-21,도봉구,277015.6734,222549.1667,11723,983,10740,0
2743,2020-05-21,동대문구,360851.8959,279431.6667,21157,1473,19684,0
2744,2020-05-21,동작구,398251.4073,298194.1667,15784,1570,14214,0
2745,2020-05-21,마포구,462088.1882,330330.4167,28401,2400,26001,0
2746,2020-05-21,서대문구,369361.1865,243077.9167,15007,1489,13518,0
2747,2020-05-21,서초구,606583.3423,417000.4167,36373,2535,33838,0
2748,2020-05-21,성동구,351850.0849,252252.9167,17062,1322,15740,0
2749,2020-05-21,성북구,429283.6204,321329.5833,17151,1584,15567,0
2750,2020-05-21,송파구,754662.842,499704.1667,37428,3169,34259,0
2751,2020-05-21,양천구,395935.6732,306156.25,18372,1663,16709,0
2752,2020-05-21,영등포구,479686.9301,393252.0833,27173,2259,24914,0
2753,2020-05-21,용산구,290389.5525,204817.0833,18924,1183,17741,0
2754,2020-05-21,은평구,438818.6314,310941.6667,18350,1572,16778,0
2755,2020-05-21,종로구,303119.5201,229678.75,25318,1608,23710,0
2756,2020-05-21,중구,289585.4606,237007.0833,40015,2062,37953,0
2757,2020-05-21,중랑구,351577.65,274266.6667,16180,1286,14894,0
2758,2020-05-22,강남구,863123.5902,633515.8333,55675,4353,51322,0
2759,2020-05-22,강동구,504459.4586,326292.0833,20935,1897,19038,1
2760,2020-05-22,강북구,299035.6252,229614.5833,13461,1066,12395,0
2761,2020-05-22,강서구,541636.6577,435250,26009,2632,23377,0
2762,2020-05-22,관악구,480578.345,384717.5,19710,1903,17807,0
2763,2020-05-22,광진구,370433.3692,280502.5,18984,1668,17316,0
2764,2020-05-22,구로구,392129.0776,352905.4167,22249,1798,20451,0
2765,2020-05-22,금천구,232480.5178,233984.1667,15627,1271,14356,0
2766,2020-05-22,노원구,521084.4679,386472.5,18235,1866,16369,0
2767,2020-05-22,도봉구,277287.387,230298.3333,11723,983,10740,0
2768,2020-05-22,동대문구,361242.945,291113.3333,21157,1473,19684,0
2769,2020-05-22,동작구,398538.3169,310302.5,15784,1570,14214,0
2770,2020-05-22,마포구,463386.6043,346583.75,28401,2400,26001,0
2771,2020-05-22,서대문구,367876.7274,251976.25,15007,1489,13518,0
2772,2020-05-22,서초구,607560.0505,439819.1667,36373,2535,33838,1
2773,2020-05-22,성동구,352616.4101,263629.1667,17062,1322,15740,0
2774,2020-05-22,성북구,429673.8246,333056.6667,17151,1584,15567,0
2775,2020-05-22,송파구,755492.7851,522575,37428,3169,34259,0
2776,2020-05-22,양천구,397428.712,318366.6667,18372,1663,16709,0
2777,2020-05-22,영등포구,476720.4394,410735.4167,27173,2259,24914,0
2778,2020-05-22,용산구,290176.5514,213568.75,18924,1183,17741,0
2779,2020-05-22,은평구,440512.1459,322650.4167,18350,1572,16778,0
2780,2020-05-22,종로구,300367.7304,239618.3333,25318,1608,23710,0
2781,2020-05-22,중구,286246.9072,249682.5,40015,2062,37953,0
2782,2020-05-22,중랑구,352291.9309,284204.1667,16180,1286,14894,1
2783,2020-05-23,강남구,737668.3631,513112.9167,55675,4353,51322,0
2784,2020-05-23,강동구,511585.4598,334710.8333,20935,1897,19038,1
2785,2020-05-23,강북구,307758.6333,239863.75,13461,1066,12395,1
2786,2020-05-23,강서구,541290.0035,438502.9167,26009,2632,23377,0
2787,2020-05-23,관악구,499783.0979,405288.3333,19710,1903,17807,1
2788,2020-05-23,광진구,380437.9304,291074.5833,18984,1668,17316,0
2789,2020-05-23,구로구,375460.3048,341603.75,22249,1798,20451,0
2790,2020-05-23,금천구,204738.124,201195.4167,15627,1271,14356,0
2791,2020-05-23,노원구,535312.9009,406912.0833,18235,1866,16369,1
2792,2020-05-23,도봉구,287844.3296,244221.6667,11723,983,10740,0
2793,2020-05-23,동대문구,355540.0659,286530.8333,21157,1473,19684,0
2794,2020-05-23,동작구,404288.3008,316309.1667,15784,1570,14214,0
2795,2020-05-23,마포구,446702.6949,329100.4167,28401,2400,26001,0
2796,2020-05-23,서대문구,348659.2984,246812.0833,15007,1489,13518,0
2797,2020-05-23,서초구,540025.5522,375848.75,36373,2535,33838,0
2798,2020-05-23,성동구,333727.2931,244828.3333,17062,1322,15740,0
2799,2020-05-23,성북구,432613.888,338837.5,17151,1584,15567,0
2800,2020-05-23,송파구,746854.2542,513858.3333,37428,3169,34259,0
2801,2020-05-23,양천구,407754.9119,333260,18372,1663,16709,0
2802,2020-05-23,영등포구,427552.0677,356445.8333,27173,2259,24914,0
2803,2020-05-23,용산구,271422.7158,196636.25,18924,1183,17741,0
2804,2020-05-23,은평구,459205.2361,343660,18350,1572,16778,0
2805,2020-05-23,종로구,253789.7796,186494.1667,25318,1608,23710,0
2806,2020-05-23,중구,208771.8786,161204.5833,40015,2062,37953,0
2807,2020-05-23,중랑구,364297.6428,297424.1667,16180,1286,14894,1
2808,2020-05-23,중랑구,364297.6428,297424.1667,16180,1286,14894,1
2809,2020-05-24,강남구,685776.1103,469000,55675,4353,51322,0
2810,2020-05-24,강동구,522725.2287,341462.9167,20935,1897,19038,0
2811,2020-05-24,강북구,318230.1119,249040.4167,13461,1066,12395,2
2812,2020-05-24,강서구,549946.5043,445419.1667,26009,2632,23377,0
2813,2020-05-24,관악구,514211.736,417121.25,19710,1903,17807,1
2814,2020-05-24,광진구,381401.0043,292827.5,18984,1668,17316,0
2815,2020-05-24,구로구,384744.9686,348042.9167,22249,1798,20451,0
2816,2020-05-24,금천구,206692.8733,202926.6667,15627,1271,14356,0
2817,2020-05-24,노원구,547195.8282,417602.5,18235,1866,16369,0
2818,2020-05-24,도봉구,294870.6711,253801.25,11723,983,10740,0
2819,2020-05-24,동대문구,356491.5301,288510.4167,21157,1473,19684,0
2820,2020-05-24,동작구,408135.3593,319370.8333,15784,1570,14214,0
2821,2020-05-24,마포구,436199.0599,319870,28401,2400,26001,0
2822,2020-05-24,서대문구,351079.0301,248940.8333,15007,1489,13518,0
2823,2020-05-24,서초구,508227.2007,348790.4167,36373,2535,33838,0
2824,2020-05-24,성동구,328018.1053,239163.3333,17062,1322,15740,1
2825,2020-05-24,성북구,443493.6411,348662.5,17151,1584,15567,0
2826,2020-05-24,송파구,743173.0898,511570.8333,37428,3169,34259,0
2827,2020-05-24,양천구,414056.1344,341516.25,18372,1663,16709,0
2828,2020-05-24,영등포구,417999.5675,347150.4167,27173,2259,24914,2
2829,2020-05-24,용산구,266832.5361,192224.1667,18924,1183,17741,0
2830,2020-05-24,은평구,471138.1643,356067.0833,18350,1572,16778,0
2831,2020-05-24,종로구,231058.909,164913.75,25318,1608,23710,0
2832,2020-05-24,중구,181155.5743,136349.5833,40015,2062,37953,0
2833,2020-05-24,중랑구,374690.7146,307388.3333,16180,1286,14894,1
2834,2020-05-25,강남구,856844.3607,632594.5833,55675,4353,51322,0
2835,2020-05-25,강동구,505592.4498,325635.4167,20935,1897,19038,1
2836,2020-05-25,강북구,300114.8061,230502.9167,13461,1066,12395,0
2837,2020-05-25,강서구,544477.948,437710,26009,2632,23377,1
2838,2020-05-25,관악구,483355.3921,385203.75,19710,1903,17807,0
2839,2020-05-25,광진구,369039.9592,279020.4167,18984,1668,17316,0
2840,2020-05-25,구로구,394902.0311,356221.6667,22249,1798,20451,1
2841,2020-05-25,금천구,236318.4089,238771.6667,15627,1271,14356,0
2842,2020-05-25,노원구,524223.9571,386811.6667,18235,1866,16369,1
2843,2020-05-25,도봉구,278618.5832,231792.5,11723,983,10740,1
2844,2020-05-25,동대문구,362300.8969,291856.25,21157,1473,19684,0
2845,2020-05-25,동작구,399622.3859,309550.4167,15784,1570,14214,0
2846,2020-05-25,마포구,460160.6997,344096.6667,28401,2400,26001,0
2847,2020-05-25,서대문구,370540.2217,252551.6667,15007,1489,13518,0
2848,2020-05-25,서초구,602050.5877,436247.9167,36373,2535,33838,0
2849,2020-05-25,성동구,350895.1824,263062.5,17062,1322,15740,3
2850,2020-05-25,성북구,432087.0952,334925.8333,17151,1584,15567,0
2851,2020-05-25,송파구,755146.2151,520700,37428,3169,34259,0
2852,2020-05-25,양천구,398900.7425,318093.3333,18372,1663,16709,0
2853,2020-05-25,영등포구,478493.7074,413287.9167,27173,2259,24914,0
2854,2020-05-25,용산구,288984.3709,213196.25,18924,1183,17741,0
2855,2020-05-25,은평구,442205.5848,323132.9167,18350,1572,16778,0
2856,2020-05-25,종로구,297895.2731,241026.25,25318,1608,23710,0
2857,2020-05-25,중구,284738.5043,255762.5,40015,2062,37953,0
2858,2020-05-25,중랑구,355271.6141,285895.4167,16180,1286,14894,0
2859,2020-05-26,강남구,869447.8026,638165.4167,55675,4353,51322,0
2860,2020-05-26,강동구,504705.0085,324722.0833,20935,1897,19038,0
2861,2020-05-26,강북구,299026.7665,229645,13461,1066,12395,0
2862,2020-05-26,강서구,543705.7415,435492.9167,26009,2632,23377,3
2863,2020-05-26,관악구,484408.0367,384705.8333,19710,1903,17807,1
2864,2020-05-26,광진구,367242.6114,277741.25,18984,1668,17316,0
2865,2020-05-26,구로구,392661.4668,353747.5,22249,1798,20451,1
2866,2020-05-26,금천구,235996.801,237053.75,15627,1271,14356,1
2867,2020-05-26,노원구,522831.8918,386123.3333,18235,1866,16369,1
2868,2020-05-26,도봉구,277127.3145,230491.25,11723,983,10740,1
2869,2020-05-26,동대문구,361785.872,291202.9167,21157,1473,19684,0
2870,2020-05-26,동작구,397430.2336,309728.3333,15784,1570,14214,0
2871,2020-05-26,마포구,462390.0229,344157.5,28401,2400,26001,0
2872,2020-05-26,서대문구,372196.0405,253537.9167,15007,1489,13518,0
2873,2020-05-26,서초구,606975.0996,438636.25,36373,2535,33838,0
2874,2020-05-26,성동구,350523.8185,263142.9167,17062,1322,15740,8
2875,2020-05-26,성북구,432084.2561,334379.5833,17151,1584,15567,0
2876,2020-05-26,송파구,756396.9726,520099.1667,37428,3169,34259,0
2877,2020-05-26,양천구,397780.8182,317621.6667,18372,1663,16709,0
2878,2020-05-26,영등포구,481467.8327,412646.25,27173,2259,24914,0
2879,2020-05-26,용산구,290484.2675,215427.0833,18924,1183,17741,0
2880,2020-05-26,은평구,440889.5848,322164.1667,18350,1572,16778,2
2881,2020-05-26,종로구,301435.0498,243273.75,25318,1608,23710,0
2882,2020-05-26,중구,289586.8878,257884.1667,40015,2062,37953,0
2883,2020-05-26,중랑구,353076.3309,284370.4167,16180,1286,14894,1
2884,2020-05-27,강남구,867542.2868,638114.1667,55675,4353,51322,0
2885,2020-05-27,강동구,504337.1824,323881.25,20935,1897,19038,1
2886,2020-05-27,강북구,298537.6557,228959.1667,13461,1066,12395,1
2887,2020-05-27,강서구,542009.3093,434920,26009,2632,23377,4
2888,2020-05-27,관악구,481888.9628,383713.3333,19710,1903,17807,2
2889,2020-05-27,광진구,369160.3037,278562.0833,18984,1668,17316,1
2890,2020-05-27,구로구,392873.4242,353895.4167,22249,1798,20451,3
2891,2020-05-27,금천구,235128.8615,236286.25,15627,1271,14356,0
2892,2020-05-27,노원구,522056.1945,385117.9167,18235,1866,16369,0
2893,2020-05-27,도봉구,276836.2831,230144.5833,11723,983,10740,0
2894,2020-05-27,동대문구,362274.5846,291000.4167,21157,1473,19684,0
2895,2020-05-27,동작구,398479.6291,309286.6667,15784,1570,14214,0
2896,2020-05-27,마포구,463490.5757,345868.3333,28401,2400,26001,1
2897,2020-05-27,서대문구,369776.4191,252440.4167,15007,1489,13518,1
2898,2020-05-27,서초구,608237.2808,438865,36373,2535,33838,0
2899,2020-05-27,성동구,350591.8193,263111.6667,17062,1322,15740,3
2900,2020-05-27,성북구,431083.3097,333992.5,17151,1584,15567,0
2901,2020-05-27,송파구,755294.6206,520751.25,37428,3169,34259,1
2902,2020-05-27,양천구,397609.6127,316929.5833,18372,1663,16709,1
2903,2020-05-27,영등포구,482692.9488,413664.1667,27173,2259,24914,1
2904,2020-05-27,용산구,292719.0317,215728.3333,18924,1183,17741,0
2905,2020-05-27,은평구,439645.7053,321258.75,18350,1572,16778,2
2906,2020-05-27,종로구,307102.0369,245778.3333,25318,1608,23710,0
2907,2020-05-27,중구,290852.0226,258081.6667,40015,2062,37953,0
2908,2020-05-27,중랑구,351172.7553,283527.0833,16180,1286,14894,3
2909,2020-05-28,강남구,867910.6907,639043.3333,55675,4353,51322,0
2910,2020-05-28,강동구,502169.6005,324125,20935,1897,19038,0
2911,2020-05-28,강북구,298335.0058,228555,13461,1066,12395,1
2912,2020-05-28,강서구,541691.5052,434377.9167,26009,2632,23377,4
2913,2020-05-28,관악구,480654.6307,382919.1667,19710,1903,17807,0
2914,2020-05-28,광진구,368602.2179,278160.8333,18984,1668,17316,0
2915,2020-05-28,구로구,392389.2551,354054.5833,22249,1798,20451,0
2916,2020-05-28,금천구,235025.8101,235536.25,15627,1271,14356,1
2917,2020-05-28,노원구,522303.4627,384940.4167,18235,1866,16369,0
2918,2020-05-28,도봉구,277076.6201,229912.0833,11723,983,10740,0
2919,2020-05-28,동대문구,361931.9689,290883.3333,21157,1473,19684,0
2920,2020-05-28,동작구,397304.5464,308754.5833,15784,1570,14214,1
2921,2020-05-28,마포구,463890.9725,345889.1667,28401,2400,26001,2
2922,2020-05-28,서대문구,370471.438,252635.4167,15007,1489,13518,2
2923,2020-05-28,서초구,610680.7951,439509.1667,36373,2535,33838,0
2924,2020-05-28,성동구,350313.3871,262933.75,17062,1322,15740,2
2925,2020-05-28,성북구,429869.9227,333675.4167,17151,1584,15567,0
2926,2020-05-28,송파구,752310.8149,519908.3333,37428,3169,34259,1
2927,2020-05-28,양천구,397497.3058,317107.5,18372,1663,16709,0
2928,2020-05-28,영등포구,481378.9796,412780,27173,2259,24914,2
2929,2020-05-28,용산구,293159.645,216413.3333,18924,1183,17741,0
2930,2020-05-28,은평구,439379.6301,321317.0833,18350,1572,16778,0
2931,2020-05-28,종로구,306322.4253,245494.1667,25318,1608,23710,0
2932,2020-05-28,중구,291019.7495,258396.25,40015,2062,37953,1
2933,2020-05-28,중랑구,351559.8025,283087.9167,16180,1286,14894,2
2934,2020-05-29,강남구,861323.3868,458656.6667,55675,4353,51322,2
2935,2020-05-29,강동구,503341.7028,228011.6667,20935,1897,19038,0
2936,2020-05-29,강북구,297995.7413,159633.75,13461,1066,12395,0
2937,2020-05-29,강서구,540250.9248,306940.4167,26009,2632,23377,0
2938,2020-05-29,관악구,480397.2497,267407.9167,19710,1903,17807,0
2939,2020-05-29,광진구,369316.6489,193612.5,18984,1668,17316,0
2940,2020-05-29,구로구,390581.5597,248895.8333,22249,1798,20451,0
2941,2020-05-29,금천구,233074.5711,169186.6667,15627,1271,14356,0
2942,2020-05-29,노원구,522063.5102,269121.25,18235,1866,16369,0
2943,2020-05-29,도봉구,276703.7459,160972.5,11723,983,10740,1
2944,2020-05-29,동대문구,359948.4111,205074.1667,21157,1473,19684,0
2945,2020-05-29,동작구,396244.4613,215776.25,15784,1570,14214,0
2946,2020-05-29,마포구,467030.4424,242531.6667,28401,2400,26001,0
2947,2020-05-29,서대문구,365934.0521,177227.0833,15007,1489,13518,1
2948,2020-05-29,서초구,609066.4188,316597.0833,36373,2535,33838,0
2949,2020-05-29,성동구,348740.6488,186195,17062,1322,15740,1
2950,2020-05-29,성북구,427458.0032,233553.3333,17151,1584,15567,1
2951,2020-05-29,송파구,753068.4523,366746.6667,37428,3169,34259,1
2952,2020-05-29,양천구,397865.4728,222064.5833,18372,1663,16709,0
2953,2020-05-29,영등포구,478475.1731,295007.9167,27173,2259,24914,0
2954,2020-05-29,용산구,292860.2954,153942.9167,18924,1183,17741,0
2955,2020-05-29,은평구,439802.7475,225029.1667,18350,1572,16778,1
2956,2020-05-29,종로구,303476.6669,177677.0833,25318,1608,23710,1
2957,2020-05-29,중구,287752.3628,190934.5833,40015,2062,37953,0
2958,2020-05-29,중랑구,350997.6392,197841.6667,16180,1286,14894,0
2959,2020-05-30,강남구,731743.5389,509552.9167,55675,4353,51322,0
2960,2020-05-30,강동구,509304.8353,333204.5833,20935,1897,19038,0
2961,2020-05-30,강북구,308438.2757,240363.3333,13461,1066,12395,0
2962,2020-05-30,강서구,539467.1927,435795.8333,26009,2632,23377,2
2963,2020-05-30,관악구,499571.5339,403900,19710,1903,17807,0
2964,2020-05-30,광진구,378029.3485,289820,18984,1668,17316,0
2965,2020-05-30,구로구,377179.9098,340710.8333,22249,1798,20451,0
2966,2020-05-30,금천구,205798.7512,200027.9167,15627,1271,14356,0
2967,2020-05-30,노원구,536505.4595,406271.25,18235,1866,16369,0
2968,2020-05-30,도봉구,286465.9945,243546.6667,11723,983,10740,0
2969,2020-05-30,동대문구,354229.8857,284166.25,21157,1473,19684,0
2970,2020-05-30,동작구,400446.1136,313928.3333,15784,1570,14214,0
2971,2020-05-30,마포구,445727.3806,326733.3333,28401,2400,26001,0
2972,2020-05-30,서대문구,347363.8161,246754.5833,15007,1489,13518,1
2973,2020-05-30,서초구,539662.672,372689.5833,36373,2535,33838,0
2974,2020-05-30,성동구,329272.6159,241382.0833,17062,1322,15740,0
2975,2020-05-30,성북구,433021.0777,339582.0833,17151,1584,15567,0
2976,2020-05-30,송파구,742999.5152,510108.3333,37428,3169,34259,0
2977,2020-05-30,양천구,408392.3995,332950.8333,18372,1663,16709,0
2978,2020-05-30,영등포구,426513.8737,353469.5833,27173,2259,24914,3
2979,2020-05-30,용산구,269236.4515,196600.4167,18924,1183,17741,0
2980,2020-05-30,은평구,459188.2358,343730.8333,18350,1572,16778,0
2981,2020-05-30,종로구,250902.8727,182956.25,25318,1608,23710,0
2982,2020-05-30,중구,204347.9339,157929.5833,40015,2062,37953,0
2983,2020-05-30,중랑구,362827.8114,296914.1667,16180,1286,14894,0
2984,2020-05-31,강남구,679440.8754,465643.75,55675,4353,51322,1
2985,2020-05-31,강동구,518259.4282,338330,20935,1897,19038,0
2986,2020-05-31,강북구,314368.8816,246342.9167,13461,1066,12395,0
2987,2020-05-31,강서구,544865.5583,440670,26009,2632,23377,0
2988,2020-05-31,관악구,509973.097,413920,19710,1903,17807,0
2989,2020-05-31,광진구,378742.0171,290571.25,18984,1668,17316,0
2990,2020-05-31,구로구,382508.9773,345401.25,22249,1798,20451,0
2991,2020-05-31,금천구,205689.4503,201287.0833,15627,1271,14356,0
2992,2020-05-31,노원구,545146.8465,415312.0833,18235,1866,16369,0
2993,2020-05-31,도봉구,295618.1691,253317.5,11723,983,10740,0
2994,2020-05-31,동대문구,354829.1471,285152.9167,21157,1473,19684,0
2995,2020-05-31,동작구,402494.2146,315112.0833,15784,1570,14214,0
2996,2020-05-31,마포구,436111.0135,319005.8333,28401,2400,26001,0
2997,2020-05-31,서대문구,346724.7001,247133.3333,15007,1489,13518,0
2998,2020-05-31,서초구,509459.3356,348441.25,36373,2535,33838,0
2999,2020-05-31,성동구,324277.0125,235919.5833,17062,1322,15740,0
3000,2020-05-31,성북구,440071.2739,346120,17151,1584,15567,0
3001,2020-05-31,송파구,736858.307,506794.5833,37428,3169,34259,0
3002,2020-05-31,양천구,412251.7139,339108.75,18372,1663,16709,0
3003,2020-05-31,영등포구,416885.645,345423.3333,27173,2259,24914,0
3004,2020-05-31,용산구,265063.1328,192370.8333,18924,1183,17741,0
3005,2020-05-31,은평구,468755.8765,352832.5,18350,1572,16778,0
3006,2020-05-31,종로구,229065.3128,163049.5833,25318,1608,23710,0
3007,2020-05-31,중구,180308.4994,135700.8333,40015,2062,37953,0
3008,2020-05-31,중랑구,373006.0383,304809.5833,16180,1286,14894,0
3009,2020-06-01,강남구,854029.2927,636920.8333,55675,4353,51322,0
3010,2020-06-01,강동구,505126.0607,327868.75,20935,1897,19038,1
3011,2020-06-01,강북구,299982.1326,232300.8333,13461,1066,12395,0
3012,2020-06-01,강서구,544026.2488,440534.5833,26009,2632,23377,2
3013,2020-06-01,관악구,483931.717,387453.3333,19710,1903,17807,1
3014,2020-06-01,광진구,368856.116,281465,18984,1668,17316,0
3015,2020-06-01,구로구,394932.0544,360997.0833,22249,1798,20451,0
3016,2020-06-01,금천구,236512.7897,241797.5,15627,1271,14356,0
3017,2020-06-01,노원구,525125.0681,388406.6667,18235,1866,16369,0
3018,2020-06-01,도봉구,278876.4828,234974.5833,11723,983,10740,0
3019,2020-06-01,동대문구,362324.3664,294190,21157,1473,19684,0
3020,2020-06-01,동작구,395992.3275,309810.4167,15784,1570,14214,0
3021,2020-06-01,마포구,460141.5181,346060.8333,28401,2400,26001,0
3022,2020-06-01,서대문구,367735.8795,253340,15007,1489,13518,1
3023,2020-06-01,서초구,598303.2655,436833.3333,36373,2535,33838,2
3024,2020-06-01,성동구,348258.6706,264395,17062,1322,15740,0
3025,2020-06-01,성북구,431189.9202,338623.3333,17151,1584,15567,0
3026,2020-06-01,송파구,751993.8125,523321.6667,37428,3169,34259,1
3027,2020-06-01,양천구,399023.8332,321714.5833,18372,1663,16709,3
3028,2020-06-01,영등포구,476620.144,415259.1667,27173,2259,24914,3
3029,2020-06-01,용산구,288583.315,216755,18924,1183,17741,0
3030,2020-06-01,은평구,442815.6688,326875.4167,18350,1572,16778,0
3031,2020-06-01,종로구,294017.1087,241400.8333,25318,1608,23710,0
3032,2020-06-01,중구,285046.9955,256195.4167,40015,2062,37953,0
3033,2020-06-01,중랑구,354377.1896,288737.0833,16180,1286,14894,0
3034,2020-06-02,강남구,863072.3657,641877.5,55675,4353,51322,1
3035,2020-06-02,강동구,504086.7847,327135,20935,1897,19038,1
3036,2020-06-02,강북구,299801.2495,233131.6667,13461,1066,12395,2
3037,2020-06-02,강서구,544531.84,440283.3333,26009,2632,23377,3
3038,2020-06-02,관악구,484261.2005,388060.4167,19710,1903,17807,0
3039,2020-06-02,광진구,368025.7714,281497.5,18984,1668,17316,0
3040,2020-06-02,구로구,394776.4921,360574.5833,22249,1798,20451,2
3041,2020-06-02,금천구,235828.5258,240627.9167,15627,1271,14356,1
3042,2020-06-02,노원구,524786.2354,389048.75,18235,1866,16369,0
3043,2020-06-02,도봉구,278277.057,234521.6667,11723,983,10740,0
3044,2020-06-02,동대문구,362414.2176,294658.3333,21157,1473,19684,0
3045,2020-06-02,동작구,398499.7295,311440.8333,15784,1570,14214,0
3046,2020-06-02,마포구,461710.7685,346618.75,28401,2400,26001,0
3047,2020-06-02,서대문구,370793.8928,254695,15007,1489,13518,2
3048,2020-06-02,서초구,604467.0795,437495,36373,2535,33838,0
3049,2020-06-02,성동구,349248.1053,263396.25,17062,1322,15740,1
3050,2020-06-02,성북구,431612.9146,338087.0833,17151,1584,15567,0
3051,2020-06-02,송파구,753472.9203,523430.8333,37428,3169,34259,0
3052,2020-06-02,양천구,399332.2942,321885.8333,18372,1663,16709,5
3053,2020-06-02,영등포구,476798.1568,412600.8333,27173,2259,24914,0
3054,2020-06-02,용산구,289444.1585,216740.8333,18924,1183,17741,0
3055,2020-06-02,은평구,442952.5353,326892.9167,18350,1572,16778,0
3056,2020-06-02,종로구,299909.5458,241683.3333,25318,1608,23710,0
3057,2020-06-02,중구,287046.6932,256682.9167,40015,2062,37953,0
3058,2020-06-02,중랑구,354216.8579,288485.4167,16180,1286,14894,2
3059,2020-06-03,강남구,866627.6837,644182.0833,55675,4353,51322,1
3060,2020-06-03,강동구,504471.0385,326698.3333,20935,1897,19038,0
3061,2020-06-03,강북구,298091.1463,231642.9167,13461,1066,12395,1
3062,2020-06-03,강서구,541884.5085,438091.25,26009,2632,23377,2
3063,2020-06-03,관악구,482486.0038,386463.75,19710,1903,17807,1
3064,2020-06-03,광진구,368481.8917,281128.75,18984,1668,17316,0
3065,2020-06-03,구로구,392275.7227,357908.75,22249,1798,20451,1
3066,2020-06-03,금천구,235764.9519,239775.4167,15627,1271,14356,2
3067,2020-06-03,노원구,522138.8024,387511.25,18235,1866,16369,0
3068,2020-06-03,도봉구,278629.003,233319.1667,11723,983,10740,1
3069,2020-06-03,동대문구,363825.7864,294434.5833,21157,1473,19684,0
3070,2020-06-03,동작구,396343.5833,310539.1667,15784,1570,14214,0
3071,2020-06-03,마포구,463884.0773,348477.0833,28401,2400,26001,1
3072,2020-06-03,서대문구,369335.1889,253963.3333,15007,1489,13518,0
3073,2020-06-03,서초구,606472.099,439153.3333,36373,2535,33838,0
3074,2020-06-03,성동구,348313.3514,263766.25,17062,1322,15740,0
3075,2020-06-03,성북구,430543.3318,337541.6667,17151,1584,15567,0
3076,2020-06-03,송파구,752545.6297,522310.8333,37428,3169,34259,0
3077,2020-06-03,양천구,397176.1644,319926.6667,18372,1663,16709,1
3078,2020-06-03,영등포구,476649.17,412672.9167,27173,2259,24914,1
3079,2020-06-03,용산구,289969.2954,217377.0833,18924,1183,17741,1
3080,2020-06-03,은평구,440251.9056,324211.6667,18350,1572,16778,0
3081,2020-06-03,종로구,305420.2837,245147.9167,25318,1608,23710,0
3082,2020-06-03,중구,288620.57,257589.5833,40015,2062,37953,0
3083,2020-06-03,중랑구,351831.6223,286834.1667,16180,1286,14894,1
3084,2020-06-04,강남구,866865.4922,644825.4167,55675,4353,51322,1
3085,2020-06-04,강동구,501956.7606,325792.9167,20935,1897,19038,2
3086,2020-06-04,강북구,296924.045,231304.1667,13461,1066,12395,0
3087,2020-06-04,강서구,540611.5792,438002.5,26009,2632,23377,2
3088,2020-06-04,관악구,482152.0705,385842.9167,19710,1903,17807,0
3089,2020-06-04,광진구,368008.4378,280483.75,18984,1668,17316,0
3090,2020-06-04,구로구,392139.2513,357332.0833,22249,1798,20451,2
3091,2020-06-04,금천구,234709.9745,238788.3333,15627,1271,14356,0
3092,2020-06-04,노원구,521942.1692,386672.9167,18235,1866,16369,1
3093,2020-06-04,도봉구,277638.1071,232649.1667,11723,983,10740,1
3094,2020-06-04,동대문구,362102.9812,293802.0833,21157,1473,19684,0
3095,2020-06-04,동작구,396071.202,309807.0833,15784,1570,14214,0
3096,2020-06-04,마포구,462884.447,347488.3333,28401,2400,26001,1
3097,2020-06-04,서대문구,368766.8427,253869.1667,15007,1489,13518,0
3098,2020-06-04,서초구,607609.4989,438612.0833,36373,2535,33838,0
3099,2020-06-04,성동구,350048.7638,263555.4167,17062,1322,15740,0
3100,2020-06-04,성북구,429809.8233,336497.0833,17151,1584,15567,0
3101,2020-06-04,송파구,752029.9545,520932.0833,37428,3169,34259,0
3102,2020-06-04,양천구,396363.3536,319586.6667,18372,1663,16709,3
3103,2020-06-04,영등포구,475793.8068,412306.6667,27173,2259,24914,0
3104,2020-06-04,용산구,290806.3727,217852.0833,18924,1183,17741,1
3105,2020-06-04,은평구,439699.8191,324244.5833,18350,1572,16778,0
3106,2020-06-04,종로구,305216.9848,244431.6667,25318,1608,23710,0
3107,2020-06-04,중구,288117.5437,257570,40015,2062,37953,0
3108,2020-06-04,중랑구,351481.9453,286439.5833,16180,1286,14894,1
3109,2020-06-05,강남구,858916.4978,637686.6667,55675,4353,51322,0
3110,2020-06-05,강동구,501024.6344,325912.0833,20935,1897,19038,3
3111,2020-06-05,강북구,296187.5807,230225.4167,13461,1066,12395,1
3112,2020-06-05,강서구,537878.3971,436200.8333,26009,2632,23377,1
3113,2020-06-05,관악구,480452.2542,384306.25,19710,1903,17807,3
3114,2020-06-05,광진구,369644.2733,281686.25,18984,1668,17316,0
3115,2020-06-05,구로구,389650.5731,354825,22249,1798,20451,3
3116,2020-06-05,금천구,232302.1384,234802.9167,15627,1271,14356,0
3117,2020-06-05,노원구,518377.1102,385907.5,18235,1866,16369,2
3118,2020-06-05,도봉구,277695.7805,231094.5833,11723,983,10740,1
3119,2020-06-05,동대문구,360742.861,291197.9167,21157,1473,19684,1
3120,2020-06-05,동작구,395704.7016,309657.9167,15784,1570,14214,0
3121,2020-06-05,마포구,464008.3502,348372.5,28401,2400,26001,0
3122,2020-06-05,서대문구,364422.8782,251695.4167,15007,1489,13518,0
3123,2020-06-05,서초구,606252.1121,436813.3333,36373,2535,33838,0
3124,2020-06-05,성동구,348303.2614,262390.8333,17062,1322,15740,1
3125,2020-06-05,성북구,426463.6146,334715.4167,17151,1584,15567,0
3126,2020-06-05,송파구,751119.5267,520012.5,37428,3169,34259,1
3127,2020-06-05,양천구,395297.7915,318953.75,18372,1663,16709,4
3128,2020-06-05,영등포구,474843.6212,410565,27173,2259,24914,1
3129,2020-06-05,용산구,290103.3036,217029.1667,18924,1183,17741,2
3130,2020-06-05,은평구,438749.614,323277.9167,18350,1572,16778,2
3131,2020-06-05,종로구,302303.0593,240228.3333,25318,1608,23710,0
3132,2020-06-05,중구,283439.6853,250323.75,40015,2062,37953,0
3133,2020-06-05,중랑구,350500.59,285585.8333,16180,1286,14894,1
3134,2020-06-06,강남구,710863.1315,496266.6667,55675,4353,51322,0
3135,2020-06-06,강동구,506665.6739,334005.8333,20935,1897,19038,0
3136,2020-06-06,강북구,305645.0334,240629.5833,13461,1066,12395,1
3137,2020-06-06,강서구,533383.3136,433710.4167,26009,2632,23377,2
3138,2020-06-06,관악구,498483.2048,401910.4167,19710,1903,17807,1
3139,2020-06-06,광진구,375440.3863,289712.0833,18984,1668,17316,0
3140,2020-06-06,구로구,374321.5915,340062.5,22249,1798,20451,4
3141,2020-06-06,금천구,202701.7026,199795.8333,15627,1271,14356,0
3142,2020-06-06,노원구,530484.3831,404788.3333,18235,1866,16369,0
3143,2020-06-06,도봉구,290022.8703,244607.0833,11723,983,10740,0
3144,2020-06-06,동대문구,350071.8621,282927.5,21157,1473,19684,0
3145,2020-06-06,동작구,399008.7444,313465,15784,1570,14214,1
3146,2020-06-06,마포구,443713.6044,328754.5833,28401,2400,26001,1
3147,2020-06-06,서대문구,343835.0321,245086.6667,15007,1489,13518,0
3148,2020-06-06,서초구,523062.9715,360322.0833,36373,2535,33838,0
3149,2020-06-06,성동구,324957.8607,237770.4167,17062,1322,15740,2
3150,2020-06-06,성북구,428752.8026,338278.75,17151,1584,15567,0
3151,2020-06-06,송파구,734893.8914,506741.6667,37428,3169,34259,0
3152,2020-06-06,양천구,402769.4374,331448.3333,18372,1663,16709,8
3153,2020-06-06,영등포구,418746.2908,349622.5,27173,2259,24914,1
3154,2020-06-06,용산구,266928.0137,196327.0833,18924,1183,17741,2
3155,2020-06-06,은평구,456174.0423,343692.0833,18350,1572,16778,2
3156,2020-06-06,종로구,244886.2318,178305,25318,1608,23710,0
3157,2020-06-06,중구,200737.5877,154287.9167,40015,2062,37953,0
3158,2020-06-06,중랑구,361315.7045,297609.1667,16180,1286,14894,4
3159,2020-06-07,강남구,675567.8714,467046.25,55675,4353,51322,0
3160,2020-06-07,강동구,513137.5359,336923.3333,20935,1897,19038,0
3161,2020-06-07,강북구,312649.6877,246685.4167,13461,1066,12395,1
3162,2020-06-07,강서구,540585.1449,440265.4167,26009,2632,23377,2
3163,2020-06-07,관악구,508700.9195,411210.4167,19710,1903,17807,0
3164,2020-06-07,광진구,376634.6232,290672.9167,18984,1668,17316,0
3165,2020-06-07,구로구,379255.0738,345944.5833,22249,1798,20451,3
3166,2020-06-07,금천구,204747.9071,202159.1667,15627,1271,14356,0
3167,2020-06-07,노원구,540815.5926,414433.3333,18235,1866,16369,0
3168,2020-06-07,도봉구,296563.4793,253663.3333,11723,983,10740,0
3169,2020-06-07,동대문구,352137.6832,285033.3333,21157,1473,19684,0
3170,2020-06-07,동작구,401958.5536,315281.6667,15784,1570,14214,0
3171,2020-06-07,마포구,436358.2762,320941.6667,28401,2400,26001,0
3172,2020-06-07,서대문구,344958.2353,247030.8333,15007,1489,13518,0
3173,2020-06-07,서초구,506160.846,346762.0833,36373,2535,33838,0
3174,2020-06-07,성동구,322654.5831,235584.1667,17062,1322,15740,2
3175,2020-06-07,성북구,439065.5814,347144.5833,17151,1584,15567,0
3176,2020-06-07,송파구,731522.5538,504082.5,37428,3169,34259,0
3177,2020-06-07,양천구,409573.1931,338493.75,18372,1663,16709,5
3178,2020-06-07,영등포구,414937.9162,345477.5,27173,2259,24914,0
3179,2020-06-07,용산구,264587.1224,192917.0833,18924,1183,17741,0
3180,2020-06-07,은평구,466657.6782,353415.4167,18350,1572,16778,0
3181,2020-06-07,종로구,228983.8977,162842.5,25318,1608,23710,0
3182,2020-06-07,중구,180028.1838,136377.0833,40015,2062,37953,0
3183,2020-06-07,중랑구,370197.2773,305659.1667,16180,1286,14894,2
3184,2020-06-08,강남구,850698.8395,636121.25,55675,4353,51322,0
3185,2020-06-08,강동구,503722.0164,326958.75,20935,1897,19038,0
3186,2020-06-08,강북구,297650.173,231459.5833,13461,1066,12395,0
3187,2020-06-08,강서구,541615.0492,438544.5833,26009,2632,23377,3
3188,2020-06-08,관악구,483263.522,385597.5,19710,1903,17807,1
3189,2020-06-08,광진구,367646.2473,279831.25,18984,1668,17316,0
3190,2020-06-08,구로구,392695.4445,357496.6667,22249,1798,20451,9
3191,2020-06-08,금천구,235101.0512,240957.9167,15627,1271,14356,0
3192,2020-06-08,노원구,521841.9563,387583.75,18235,1866,16369,0
3193,2020-06-08,도봉구,280451.156,233470.8333,11723,983,10740,0
3194,2020-06-08,동대문구,361707.005,292886.25,21157,1473,19684,0
3195,2020-06-08,동작구,397787.056,311720,15784,1570,14214,0
3196,2020-06-08,마포구,460047.2246,345845,28401,2400,26001,0
3197,2020-06-08,서대문구,367646.7837,253572.5,15007,1489,13518,1
3198,2020-06-08,서초구,601398.4281,434762.5,36373,2535,33838,1
3199,2020-06-08,성동구,346545.4191,261037.0833,17062,1322,15740,0
3200,2020-06-08,성북구,431002.2078,337000,17151,1584,15567,0
3201,2020-06-08,송파구,748141.3821,518169.1667,37428,3169,34259,0
3202,2020-06-08,양천구,397121.4391,319434.5833,18372,1663,16709,1
3203,2020-06-08,영등포구,473801.516,412158.75,27173,2259,24914,0
3204,2020-06-08,용산구,287583.4255,214466.25,18924,1183,17741,0
3205,2020-06-08,은평구,441794.295,325065.8333,18350,1572,16778,0
3206,2020-06-08,종로구,297286.6995,239163.75,25318,1608,23710,0
3207,2020-06-08,중구,282942.6092,254133.3333,40015,2062,37953,0
3208,2020-06-08,중랑구,353353.3617,287480.4167,16180,1286,14894,1
3209,2020-06-08,중랑구,353353.3617,287480.4167,16180,1286,14894,1
3210,2020-06-09,강남구,862335.5307,642877.5,55675,4353,51322,0
3211,2020-06-09,강동구,500683.3758,325228.75,20935,1897,19038,0
3212,2020-06-09,강북구,295956.6534,230147.9167,13461,1066,12395,0
3213,2020-06-09,강서구,539263.0903,436124.5833,26009,2632,23377,0
3214,2020-06-09,관악구,481244.9106,384672.5,19710,1903,17807,2
3215,2020-06-09,광진구,365554.9922,277942.5,18984,1668,17316,0
3216,2020-06-09,구로구,389384.5765,355338.3333,22249,1798,20451,1
3217,2020-06-09,금천구,233974.4313,238752.9167,15627,1271,14356,1
3218,2020-06-09,노원구,518693.8807,385352.0833,18235,1866,16369,0
3219,2020-06-09,도봉구,278576.3778,231701.25,11723,983,10740,0
3220,2020-06-09,동대문구,360364.7271,292217.9167,21157,1473,19684,0
3221,2020-06-09,동작구,395826.7998,311412.9167,15784,1570,14214,3
3222,2020-06-09,마포구,461421.2003,346707.5,28401,2400,26001,1
3223,2020-06-09,서대문구,368881.0189,254203.75,15007,1489,13518,0
3224,2020-06-09,서초구,605343.0291,437607.9167,36373,2535,33838,0
3225,2020-06-09,성동구,348000.3646,263803.3333,17062,1322,15740,1
3226,2020-06-09,성북구,428427.3458,335677.9167,17151,1584,15567,0
3227,2020-06-09,송파구,746672.6193,517665,37428,3169,34259,0
3228,2020-06-09,양천구,394453.4,317737.0833,18372,1663,16709,2
3229,2020-06-09,영등포구,475911.2514,412780.8333,27173,2259,24914,1
3230,2020-06-09,용산구,289308.8601,216828.75,18924,1183,17741,0
3231,2020-06-09,은평구,437874.6795,323003.3333,18350,1572,16778,0
3232,2020-06-09,종로구,302278.7451,243542.9167,25318,1608,23710,0
3233,2020-06-09,중구,288288.9866,258552.9167,40015,2062,37953,1
3234,2020-06-09,중랑구,350430.3534,285066.6667,16180,1286,14894,1
3235,2020-06-10,강남구,867002.6784,643830,55675,4353,51322,0
3236,2020-06-10,강동구,503759.6745,325660,20935,1897,19038,0
3237,2020-06-10,강북구,296517.3019,229795,13461,1066,12395,0
3238,2020-06-10,강서구,540896.0025,436143.75,26009,2632,23377,0
3239,2020-06-10,관악구,483761.5346,385172.9167,19710,1903,17807,1
3240,2020-06-10,광진구,367664.4028,277970,18984,1668,17316,1
3241,2020-06-10,구로구,391136.8755,355863.3333,22249,1798,20451,2
3242,2020-06-10,금천구,236097.7545,238332.0833,15627,1271,14356,4
3243,2020-06-10,노원구,521370.1763,385048.75,18235,1866,16369,1
3244,2020-06-10,도봉구,279368.8182,232130,11723,983,10740,1
3245,2020-06-10,동대문구,361975.6665,292829.1667,21157,1473,19684,0
3246,2020-06-10,동작구,397716.8072,311723.3333,15784,1570,14214,1
3247,2020-06-10,마포구,464402.5924,346884.5833,28401,2400,26001,0
3248,2020-06-10,서대문구,370509.0743,253721.25,15007,1489,13518,0
3249,2020-06-10,서초구,605934.9948,436449.5833,36373,2535,33838,1
3250,2020-06-10,성동구,349904.3232,264395,17062,1322,15740,0
3251,2020-06-10,성북구,430070.3598,336426.6667,17151,1584,15567,1
3252,2020-06-10,송파구,749387.5992,517869.1667,37428,3169,34259,1
3253,2020-06-10,양천구,395560.3559,317245.8333,18372,1663,16709,3
3254,2020-06-10,영등포구,481080.8526,413865.4167,27173,2259,24914,0
3255,2020-06-10,용산구,291149.9754,217517.5,18924,1183,17741,0
3256,2020-06-10,은평구,440617.934,323532.5,18350,1572,16778,1
3257,2020-06-10,종로구,303149.8354,242683.75,25318,1608,23710,0
3258,2020-06-10,중구,287958.8278,256929.1667,40015,2062,37953,0
3259,2020-06-10,중랑구,350993.8894,285357.9167,16180,1286,14894,1
3260,2020-06-11,강남구,867998.3393,644552.9167,55675,4353,51322,0
3261,2020-06-11,강동구,501874.9628,324052.0833,20935,1897,19038,1
3262,2020-06-11,강북구,296417.899,229521.6667,13461,1066,12395,0
3263,2020-06-11,강서구,540463.818,437235.4167,26009,2632,23377,3
3264,2020-06-11,관악구,483007.7312,383811.25,19710,1903,17807,5
3265,2020-06-11,광진구,368033.4346,277895,18984,1668,17316,0
3266,2020-06-11,구로구,390941.342,355017.0833,22249,1798,20451,1
3267,2020-06-11,금천구,235396.8279,237977.0833,15627,1271,14356,3
3268,2020-06-11,노원구,521073.1468,385216.6667,18235,1866,16369,1
3269,2020-06-11,도봉구,278264.198,231235.4167,11723,983,10740,1
3270,2020-06-11,동대문구,361404.2636,292085.4167,21157,1473,19684,0
3271,2020-06-11,동작구,396692.5405,310372.9167,15784,1570,14214,0
3272,2020-06-11,마포구,466034.7607,348290.4167,28401,2400,26001,0
3273,2020-06-11,서대문구,370553.9325,254371.25,15007,1489,13518,0
3274,2020-06-11,서초구,607378.8471,436688.75,36373,2535,33838,1
3275,2020-06-11,성동구,349503.6085,263855.8333,17062,1322,15740,0
3276,2020-06-11,성북구,430095.7168,335870.8333,17151,1584,15567,0
3277,2020-06-11,송파구,749521.0241,518298.3333,37428,3169,34259,0
3278,2020-06-11,양천구,395254.0313,316127.9167,18372,1663,16709,1
3279,2020-06-11,영등포구,477727.0686,412442.0833,27173,2259,24914,5
3280,2020-06-11,용산구,292049.5686,217818.3333,18924,1183,17741,0
3281,2020-06-11,은평구,439796.4827,322665.8333,18350,1572,16778,1
3282,2020-06-11,종로구,304245.1093,243464.5833,25318,1608,23710,0
3283,2020-06-11,중구,290167.5626,258639.5833,40015,2062,37953,0
3284,2020-06-11,중랑구,351805.0183,284904.1667,16180,1286,14894,2
3285,2020-06-12,강남구,861084.5564,639415.8333,55675,4353,51322,0
3286,2020-06-12,강동구,500856.514,324107.5,20935,1897,19038,1
3287,2020-06-12,강북구,296372.5524,229928.3333,13461,1066,12395,2
3288,2020-06-12,강서구,538134.1229,436171.25,26009,2632,23377,2
3289,2020-06-12,관악구,481329.9504,382303.75,19710,1903,17807,1
3290,2020-06-12,광진구,369777.604,280708.3333,18984,1668,17316,0
3291,2020-06-12,구로구,388440.3868,353285.8333,22249,1798,20451,1
3292,2020-06-12,금천구,231595.152,234365.4167,15627,1271,14356,1
3293,2020-06-12,노원구,520119.7079,385572.9167,18235,1866,16369,1
3294,2020-06-12,도봉구,278454.8739,230785,11723,983,10740,12
3295,2020-06-12,동대문구,360336.882,291050.8333,21157,1473,19684,0
3296,2020-06-12,동작구,394815.3885,309799.5833,15784,1570,14214,0
3297,2020-06-12,마포구,467151.9107,349497.9167,28401,2400,26001,0
3298,2020-06-12,서대문구,365866.4056,252709.1667,15007,1489,13518,0
3299,2020-06-12,서초구,607251.3538,435261.25,36373,2535,33838,0
3300,2020-06-12,성동구,349112.7731,261617.0833,17062,1322,15740,0
3301,2020-06-12,성북구,427063.3545,334073.3333,17151,1584,15567,1
3302,2020-06-12,송파구,748299.9581,517579.5833,37428,3169,34259,0
3303,2020-06-12,양천구,395257.4727,316275.8333,18372,1663,16709,2
3304,2020-06-12,영등포구,471320.6741,409880.4167,27173,2259,24914,1
3305,2020-06-12,용산구,292487.4065,217484.5833,18924,1183,17741,1
3306,2020-06-12,은평구,438994.4214,322357.9167,18350,1572,16778,0
3307,2020-06-12,종로구,300200.185,238740.8333,25318,1608,23710,1
3308,2020-06-12,중구,285564.0141,251767.5,40015,2062,37953,0
3309,2020-06-12,중랑구,350646.4643,284362.0833,16180,1286,14894,3
3310,2020-06-13,강남구,736552.8653,519191.25,55675,4353,51322,0
3311,2020-06-13,강동구,509617.618,334187.5,20935,1897,19038,0
3312,2020-06-13,강북구,306750.5011,241763.3333,13461,1066,12395,1
3313,2020-06-13,강서구,538503.915,439829.5833,26009,2632,23377,2
3314,2020-06-13,관악구,500523.4102,404081.25,19710,1903,17807,2
3315,2020-06-13,광진구,377717.8624,291087.0833,18984,1668,17316,0
3316,2020-06-13,구로구,377017.5928,343966.6667,22249,1798,20451,0
3317,2020-06-13,금천구,205294.1112,202257.9167,15627,1271,14356,1
3318,2020-06-13,노원구,535022.9766,407571.6667,18235,1866,16369,0
3319,2020-06-13,도봉구,289238.3695,244462.5,11723,983,10740,0
3320,2020-06-13,동대문구,354711.6651,287380.4167,21157,1473,19684,0
3321,2020-06-13,동작구,398513.9527,314824.1667,15784,1570,14214,0
3322,2020-06-13,마포구,451456.6345,333004.1667,28401,2400,26001,0
3323,2020-06-13,서대문구,349307.9162,249742.0833,15007,1489,13518,0
3324,2020-06-13,서초구,538802.22,372747.0833,36373,2535,33838,1
3325,2020-06-13,성동구,329773.0398,243063.75,17062,1322,15740,0
3326,2020-06-13,성북구,431696.3502,341276.6667,17151,1584,15567,0
3327,2020-06-13,송파구,737948.0367,509565,37428,3169,34259,0
3328,2020-06-13,양천구,405471.8751,332723.75,18372,1663,16709,0
3329,2020-06-13,영등포구,422975.8664,355287.5,27173,2259,24914,2
3330,2020-06-13,용산구,272472.0576,199520.8333,18924,1183,17741,0
3331,2020-06-13,은평구,459436.4581,344898.3333,18350,1572,16778,1
3332,2020-06-13,종로구,247270.7637,180889.1667,25318,1608,23710,1
3333,2020-06-13,중구,205498.6158,159667.9167,40015,2062,37953,0
3334,2020-06-13,중랑구,363255.3126,298942.0833,16180,1286,14894,1
3335,2020-06-14,강남구,682000.4923,471860.4167,55675,4353,51322,0
3336,2020-06-14,강동구,515967.4985,338966.25,20935,1897,19038,0
3337,2020-06-14,강북구,313695.219,248075.8333,13461,1066,12395,0
3338,2020-06-14,강서구,541826.1987,443008.75,26009,2632,23377,0
3339,2020-06-14,관악구,510395.514,413758.75,19710,1903,17807,0
3340,2020-06-14,광진구,378331.0747,292495.4167,18984,1668,17316,0
3341,2020-06-14,구로구,380518.8863,347664.5833,22249,1798,20451,1
3342,2020-06-14,금천구,205234.6975,202332.9167,15627,1271,14356,0
3343,2020-06-14,노원구,542488.8205,414875,18235,1866,16369,0
3344,2020-06-14,도봉구,295973.4714,253229.5833,11723,983,10740,1
3345,2020-06-14,동대문구,353645.2315,287330.4167,21157,1473,19684,0
3346,2020-06-14,동작구,400473.9213,315724.1667,15784,1570,14214,0
3347,2020-06-14,마포구,440654.6088,322883.3333,28401,2400,26001,0
3348,2020-06-14,서대문구,349208.2025,249913.3333,15007,1489,13518,1
3349,2020-06-14,서초구,509396.2305,347573.75,36373,2535,33838,1
3350,2020-06-14,성동구,324551.9497,236714.1667,17062,1322,15740,0
3351,2020-06-14,성북구,439885.4785,347988.3333,17151,1584,15567,0
3352,2020-06-14,송파구,731939.6394,504825.8333,37428,3169,34259,0
3353,2020-06-14,양천구,409507.2873,337996.6667,18372,1663,16709,0
3354,2020-06-14,영등포구,413731.267,345326.6667,27173,2259,24914,0
3355,2020-06-14,용산구,268478.5852,195868.3333,18924,1183,17741,1
3356,2020-06-14,은평구,467719.3712,354085.8333,18350,1572,16778,1
3357,2020-06-14,종로구,229921.3474,163865.8333,25318,1608,23710,0
3358,2020-06-14,중구,180405.2432,136752.9167,40015,2062,37953,0
3359,2020-06-14,중랑구,370257.6444,305744.1667,16180,1286,14894,1
3360,2020-06-15,강남구,853765.3012,636843.3333,55675,4353,51322,0
3361,2020-06-15,강동구,501776.0297,324705.8333,20935,1897,19038,0
3362,2020-06-15,강북구,297233.9919,230643.75,13461,1066,12395,0
3363,2020-06-15,강서구,540378.5288,438290.4167,26009,2632,23377,0
3364,2020-06-15,관악구,482785.3778,384241.25,19710,1903,17807,0
3365,2020-06-15,광진구,367684.4583,278707.9167,18984,1668,17316,0
3366,2020-06-15,구로구,390882.5925,356840.8333,22249,1798,20451,4
3367,2020-06-15,금천구,235229.98,239541.25,15627,1271,14356,1
3368,2020-06-15,노원구,522372.0967,385838.3333,18235,1866,16369,0
3369,2020-06-15,도봉구,278998.6203,231933.3333,11723,983,10740,1
3370,2020-06-15,동대문구,362033.6403,293012.0833,21157,1473,19684,0
3371,2020-06-15,동작구,395414.6147,309972.0833,15784,1570,14214,1
3372,2020-06-15,마포구,462009.6958,345661.6667,28401,2400,26001,0
3373,2020-06-15,서대문구,369285.7247,253238.3333,15007,1489,13518,1
3374,2020-06-15,서초구,601914.1448,432823.75,36373,2535,33838,0
3375,2020-06-15,성동구,349995.0669,263541.6667,17062,1322,15740,0
3376,2020-06-15,성북구,429179.1764,335602.9167,17151,1584,15567,0
3377,2020-06-15,송파구,747402.2623,517296.25,37428,3169,34259,0
3378,2020-06-15,양천구,395288.7324,316492.5,18372,1663,16709,0
3379,2020-06-15,영등포구,473002.0846,411718.75,27173,2259,24914,0
3380,2020-06-15,용산구,289502.4187,215763.75,18924,1183,17741,2
3381,2020-06-15,은평구,440049.4818,323542.5,18350,1572,16778,1
3382,2020-06-15,종로구,297959.8517,239295,25318,1608,23710,0
3383,2020-06-15,중구,285760.6437,255864.5833,40015,2062,37953,0
3384,2020-06-15,중랑구,351932.6528,286159.1667,16180,1286,14894,0
3385,2020-06-16,강남구,868019.3213,645021.6667,55675,4353,51322,1
3386,2020-06-16,강동구,499796.2291,323577.5,20935,1897,19038,0
3387,2020-06-16,강북구,295850.8941,229290.4167,13461,1066,12395,0
3388,2020-06-16,강서구,538531.2497,435724.5833,26009,2632,23377,0
3389,2020-06-16,관악구,481156.5656,382884.5833,19710,1903,17807,2
3390,2020-06-16,광진구,366461.9917,277857.0833,18984,1668,17316,0
3391,2020-06-16,구로구,389757.6497,353931.25,22249,1798,20451,0
3392,2020-06-16,금천구,235605.803,237900.4167,15627,1271,14356,0
3393,2020-06-16,노원구,520100.9791,383936.6667,18235,1866,16369,0
3394,2020-06-16,도봉구,277560.3718,230256.6667,11723,983,10740,2
3395,2020-06-16,동대문구,361940.895,292654.5833,21157,1473,19684,0
3396,2020-06-16,동작구,395702.9549,310295,15784,1570,14214,2
3397,2020-06-16,마포구,464321.8319,346695,28401,2400,26001,1
3398,2020-06-16,서대문구,369924.8543,253237.9167,15007,1489,13518,0
3399,2020-06-16,서초구,606792.2727,435772.9167,36373,2535,33838,1
3400,2020-06-16,성동구,351759.1887,263968.75,17062,1322,15740,0
3401,2020-06-16,성북구,429039.7142,334985.4167,17151,1584,15567,0
3402,2020-06-16,송파구,746691.4692,516100.8333,37428,3169,34259,1
3403,2020-06-16,양천구,394727.3213,315194.5833,18372,1663,16709,0
3404,2020-06-16,영등포구,474050.5546,411598.75,27173,2259,24914,0
3405,2020-06-16,용산구,291474.8067,216864.5833,18924,1183,17741,0
3406,2020-06-16,은평구,438039.7834,321600.4167,18350,1572,16778,3
3407,2020-06-16,종로구,304418.2843,244002.5,25318,1608,23710,0
3408,2020-06-16,중구,291352.2663,258631.25,40015,2062,37953,0
3409,2020-06-16,중랑구,350116.4217,283734.1667,16180,1286,14894,1
3410,2020-06-17,강남구,871175.8798,644760.8333,55675,4353,51322,0
3411,2020-06-17,강동구,500670.3272,324316.6667,20935,1897,19038,0
3412,2020-06-17,강북구,295783.0308,228879.5833,13461,1066,12395,0
3413,2020-06-17,강서구,538468.4053,435004.1667,26009,2632,23377,2
3414,2020-06-17,관악구,483577.6779,383260.4167,19710,1903,17807,3
3415,2020-06-17,광진구,367058.783,277155.8333,18984,1668,17316,0
3416,2020-06-17,구로구,389734.7726,354034.1667,22249,1798,20451,1
3417,2020-06-17,금천구,233110.2813,237142.9167,15627,1271,14356,0
3418,2020-06-17,노원구,520135.0629,383040.8333,18235,1866,16369,0
3419,2020-06-17,도봉구,277080.5585,229787.9167,11723,983,10740,11
3420,2020-06-17,동대문구,362792.4538,292543.75,21157,1473,19684,0
3421,2020-06-17,동작구,395111.5939,310057.0833,15784,1570,14214,0
3422,2020-06-17,마포구,465727.1802,346936.6667,28401,2400,26001,0
3423,2020-06-17,서대문구,370362.1391,253296.6667,15007,1489,13518,0
3424,2020-06-17,서초구,608094.054,437165.4167,36373,2535,33838,1
3425,2020-06-17,성동구,351221.1793,263432.5,17062,1322,15740,0
3426,2020-06-17,성북구,429472.6605,335490.4167,17151,1584,15567,0
3427,2020-06-17,송파구,748043.1883,516547.9167,37428,3169,34259,0
3428,2020-06-17,양천구,394087.3934,314970.8333,18372,1663,16709,0
3429,2020-06-17,영등포구,475247.9257,411830.4167,27173,2259,24914,3
3430,2020-06-17,용산구,291645.5295,217032.9167,18924,1183,17741,0
3431,2020-06-17,은평구,437945.2474,321230.8333,18350,1572,16778,2
3432,2020-06-17,종로구,305981.5384,244089.1667,25318,1608,23710,0
3433,2020-06-17,중구,291080.7039,257590.8333,40015,2062,37953,0
3434,2020-06-17,중랑구,348362.4802,283313.75,16180,1286,14894,1
3435,2020-06-18,강남구,868683.8655,643864.1667,55675,4353,51322,0
3436,2020-06-18,강동구,500127.2341,322882.9167,20935,1897,19038,0
3437,2020-06-18,강북구,295717.9367,228552.0833,13461,1066,12395,1
3438,2020-06-18,강서구,538743.2851,435370.8333,26009,2632,23377,2
3439,2020-06-18,관악구,480929.2575,382261.25,19710,1903,17807,1
3440,2020-06-18,광진구,366757.192,277527.5,18984,1668,17316,1
3441,2020-06-18,구로구,390083.7643,353447.0833,22249,1798,20451,0
3442,2020-06-18,금천구,234048.9768,237046.25,15627,1271,14356,0
3443,2020-06-18,노원구,517651.245,382380.8333,18235,1866,16369,0
3444,2020-06-18,도봉구,277319.1705,229927.5,11723,983,10740,2
3445,2020-06-18,동대문구,362579.0951,292074.5833,21157,1473,19684,0
3446,2020-06-18,동작구,394591.1516,308711.25,15784,1570,14214,0
3447,2020-06-18,마포구,465893.9381,347470.4167,28401,2400,26001,1
3448,2020-06-18,서대문구,370048.4037,253243.3333,15007,1489,13518,1
3449,2020-06-18,서초구,608155.7706,436564.5833,36373,2535,33838,1
3450,2020-06-18,성동구,350021.3203,262393.3333,17062,1322,15740,0
3451,2020-06-18,성북구,428993.3914,334504.5833,17151,1584,15567,1
3452,2020-06-18,송파구,747029.7461,516782.0833,37428,3169,34259,0
3453,2020-06-18,양천구,393992.8519,314871.25,18372,1663,16709,2
3454,2020-06-18,영등포구,473768.8929,410240,27173,2259,24914,1
3455,2020-06-18,용산구,292515.6257,217275.4167,18924,1183,17741,0
3456,2020-06-18,은평구,438146.4546,321144.1667,18350,1572,16778,1
3457,2020-06-18,종로구,305913.034,243680,25318,1608,23710,0
3458,2020-06-18,중구,292019.628,258397.5,40015,2062,37953,1
3459,2020-06-18,중랑구,349128.4353,283058.3333,16180,1286,14894,1
3460,2020-06-18,중랑구,349128.4353,283058.3333,16180,1286,14894,1
3461,2020-06-19,강남구,861333.9994,638751.6667,55675,4353,51322,0
3462,2020-06-19,강동구,498398.7577,323312.0833,20935,1897,19038,0
3463,2020-06-19,강북구,294252.5507,228365.4167,13461,1066,12395,0
3464,2020-06-19,강서구,536995.1509,434483.3333,26009,2632,23377,1
3465,2020-06-19,관악구,479251.6999,380678.3333,19710,1903,17807,0
3466,2020-06-19,광진구,367990.3797,278943.3333,18984,1668,17316,0
3467,2020-06-19,구로구,387561.6419,351331.6667,22249,1798,20451,0
3468,2020-06-19,금천구,229559.1773,232675,15627,1271,14356,1
3469,2020-06-19,노원구,517750.9141,381996.25,18235,1866,16369,0
3470,2020-06-19,도봉구,276175.7087,228971.25,11723,983,10740,2
3471,2020-06-19,동대문구,361145.2189,290365,21157,1473,19684,1
3472,2020-06-19,동작구,393124.6434,307949.5833,15784,1570,14214,1
3473,2020-06-19,마포구,467515.7888,348792.9167,28401,2400,26001,1
3474,2020-06-19,서대문구,364043.0855,251144.5833,15007,1489,13518,1
3475,2020-06-19,서초구,607362.3744,435712.0833,36373,2535,33838,1
3476,2020-06-19,성동구,349372.8001,262080,17062,1322,15740,0
3477,2020-06-19,성북구,426687.1967,333336.6667,17151,1584,15567,0
3478,2020-06-19,송파구,744542.1809,514985,37428,3169,34259,0
3479,2020-06-19,양천구,393114.6834,314542.9167,18372,1663,16709,2
3480,2020-06-19,영등포구,471918.2526,408968.3333,27173,2259,24914,2
3481,2020-06-19,용산구,294033.1987,217305.4167,18924,1183,17741,0
3482,2020-06-19,은평구,437531.6924,320143.3333,18350,1572,16778,1
3483,2020-06-19,종로구,302884.4026,239862.0833,25318,1608,23710,0
3484,2020-06-19,중구,285919.7922,249760.8333,40015,2062,37953,0
3485,2020-06-19,중랑구,348015.9126,282097.5,16180,1286,14894,1
3486,2020-06-19,중랑구,348015.9126,282097.5,16180,1286,14894,1
3487,2020-06-20,강남구,734682.1916,514506.6667,55675,4353,51322,0
3488,2020-06-20,강동구,503240.5137,330432.9167,20935,1897,19038,0
3489,2020-06-20,강북구,305194.9455,238479.1667,13461,1066,12395,0
3490,2020-06-20,강서구,531253.8542,433623.3333,26009,2632,23377,1
3491,2020-06-20,관악구,493052.7807,397467.0833,19710,1903,17807,1
3492,2020-06-20,광진구,374014.2336,287885.4167,18984,1668,17316,0
3493,2020-06-20,구로구,372962.3347,338843.3333,22249,1798,20451,0
3494,2020-06-20,금천구,201952.048,198265,15627,1271,14356,1
3495,2020-06-20,노원구,528522.5939,400905,18235,1866,16369,2
3496,2020-06-20,도봉구,285484.2341,240688.3333,11723,983,10740,2
3497,2020-06-20,동대문구,352867.1302,285385.8333,21157,1473,19684,0
3498,2020-06-20,동작구,396689.4289,312097.5,15784,1570,14214,1
3499,2020-06-20,마포구,448961.6915,330731.25,28401,2400,26001,0
3500,2020-06-20,서대문구,345828.1871,246200.4167,15007,1489,13518,0
3501,2020-06-20,서초구,538618.8979,371821.25,36373,2535,33838,1
3502,2020-06-20,성동구,328723.4931,240530,17062,1322,15740,2
3503,2020-06-20,성북구,426886.4904,338418.3333,17151,1584,15567,0
3504,2020-06-20,송파구,732062.6861,503151.6667,37428,3169,34259,0
3505,2020-06-20,양천구,401958.1362,327693.75,18372,1663,16709,0
3506,2020-06-20,영등포구,422265.5422,352237.5,27173,2259,24914,3
3507,2020-06-20,용산구,273832.5167,198654.1667,18924,1183,17741,0
3508,2020-06-20,은평구,453811.74,340556.25,18350,1572,16778,0
3509,2020-06-20,종로구,251118.4873,182723.75,25318,1608,23710,0
3510,2020-06-20,중구,205906.8331,159962.9167,40015,2062,37953,0
3511,2020-06-20,중랑구,357408.7827,293540,16180,1286,14894,1
3512,2020-06-21,강남구,683255.3878,469528.3333,55675,4353,51322,0
3513,2020-06-21,강동구,511292.0454,334942.0833,20935,1897,19038,0
3514,2020-06-21,강북구,310871.7366,245270.8333,13461,1066,12395,0
3515,2020-06-21,강서구,536850.0287,438580.8333,26009,2632,23377,1
3516,2020-06-21,관악구,502905.265,406947.5,19710,1903,17807,0
3517,2020-06-21,광진구,373926.4456,287087.9167,18984,1668,17316,0
3518,2020-06-21,구로구,376417.6509,343381.6667,22249,1798,20451,4
3519,2020-06-21,금천구,202410.505,199444.1667,15627,1271,14356,0
3520,2020-06-21,노원구,536951.4404,410117.0833,18235,1866,16369,0
3521,2020-06-21,도봉구,294328.2672,250371.6667,11723,983,10740,1
3522,2020-06-21,동대문구,352791.5029,285081.6667,21157,1473,19684,0
3523,2020-06-21,동작구,398312.2295,312923.3333,15784,1570,14214,0
3524,2020-06-21,마포구,437566.797,319391.6667,28401,2400,26001,0
3525,2020-06-21,서대문구,344395.3721,247926.6667,15007,1489,13518,0
3526,2020-06-21,서초구,510026.5009,348322.0833,36373,2535,33838,0
3527,2020-06-21,성동구,320681.3111,234291.25,17062,1322,15740,0
3528,2020-06-21,성북구,437407.7672,346678.3333,17151,1584,15567,1
3529,2020-06-21,송파구,723357.3919,499357.0833,37428,3169,34259,1
3530,2020-06-21,양천구,406322.3625,334574.5833,18372,1663,16709,0
3531,2020-06-21,영등포구,414174.2094,343506.6667,27173,2259,24914,0
3532,2020-06-21,용산구,267351.584,193592.5,18924,1183,17741,0
3533,2020-06-21,은평구,463954.8825,350909.5833,18350,1572,16778,0
3534,2020-06-21,종로구,230421.2166,163596.6667,25318,1608,23710,0
3535,2020-06-21,중구,180742.7376,136398.3333,40015,2062,37953,0
3536,2020-06-21,중랑구,367996.3761,302532.5,16180,1286,14894,0
3537,2020-06-22,강남구,852662.2014,634825.4167,55675,4353,51322,1
3538,2020-06-22,강동구,498799.1783,323452.9167,20935,1897,19038,2
3539,2020-06-22,강북구,297126.2916,229387.9167,13461,1066,12395,0
3540,2020-06-22,강서구,538400.517,436102.5,26009,2632,23377,1
3541,2020-06-22,관악구,479488.5027,381418.75,19710,1903,17807,0
3542,2020-06-22,광진구,365314.747,276985,18984,1668,17316,0
3543,2020-06-22,구로구,389025.6577,354947.5,22249,1798,20451,0
3544,2020-06-22,금천구,233077.0749,237777.0833,15627,1271,14356,0
3545,2020-06-22,노원구,520711.4053,384954.5833,18235,1866,16369,0
3546,2020-06-22,도봉구,277922.8364,230736.6667,11723,983,10740,0
3547,2020-06-22,동대문구,363318.0345,293260,21157,1473,19684,0
3548,2020-06-22,동작구,394046.5272,307349.5833,15784,1570,14214,0
3549,2020-06-22,마포구,460740.8951,344800.4167,28401,2400,26001,0
3550,2020-06-22,서대문구,364698.9491,252220,15007,1489,13518,0
3551,2020-06-22,서초구,598203.5073,431712.0833,36373,2535,33838,0
3552,2020-06-22,성동구,345271.9202,259728.3333,17062,1322,15740,0
3553,2020-06-22,성북구,431263.9512,336991.6667,17151,1584,15567,0
3554,2020-06-22,송파구,741793.1785,514592.5,37428,3169,34259,0
3555,2020-06-22,양천구,393842.0192,315358.75,18372,1663,16709,0
3556,2020-06-22,영등포구,472019.1652,409177.9167,27173,2259,24914,0
3557,2020-06-22,용산구,288477.9898,214581.25,18924,1183,17741,0
3558,2020-06-22,은평구,440282.1039,322341.6667,18350,1572,16778,0
3559,2020-06-22,종로구,297413.4529,237157.5,25318,1608,23710,0
3560,2020-06-22,중구,284355.0533,254740,40015,2062,37953,0
3561,2020-06-22,중랑구,350906.2473,284596.25,16180,1286,14894,0
3562,2020-06-23,강남구,866920.5321,643014.1667,55675,4353,51322,0
3563,2020-06-23,강동구,496364.0894,322348.75,20935,1897,19038,0
3564,2020-06-23,강북구,294977.1949,228170.4167,13461,1066,12395,0
3565,2020-06-23,강서구,536583.0531,433779.5833,26009,2632,23377,0
3566,2020-06-23,관악구,477847.8677,380025.4167,19710,1903,17807,4
3567,2020-06-23,광진구,363101.8185,275468.3333,18984,1668,17316,0
3568,2020-06-23,구로구,386637.271,351549.1667,22249,1798,20451,1
3569,2020-06-23,금천구,232185.4558,236025.4167,15627,1271,14356,0
3570,2020-06-23,노원구,517687.9161,382389.1667,18235,1866,16369,0
3571,2020-06-23,도봉구,276638.0092,229261.6667,11723,983,10740,3
3572,2020-06-23,동대문구,362265.3056,293042.0833,21157,1473,19684,0
3573,2020-06-23,동작구,392861.3079,307598.75,15784,1570,14214,0
3574,2020-06-23,마포구,463050.1911,346406.25,28401,2400,26001,0
3575,2020-06-23,서대문구,364603.5575,252477.0833,15007,1489,13518,0
3576,2020-06-23,서초구,604138.7808,436030.8333,36373,2535,33838,0
3577,2020-06-23,성동구,345958.2441,261436.25,17062,1322,15740,0
3578,2020-06-23,성북구,429617.3946,336081.6667,17151,1584,15567,0
3579,2020-06-23,송파구,742178.0324,514191.6667,37428,3169,34259,0
3580,2020-06-23,양천구,392364.9244,313939.5833,18372,1663,16709,0
3581,2020-06-23,영등포구,473067.7741,409808.75,27173,2259,24914,1
3582,2020-06-23,용산구,291174.2055,216562.9167,18924,1183,17741,0
3583,2020-06-23,은평구,438261.7072,320270.4167,18350,1572,16778,0
3584,2020-06-23,종로구,303907.1845,242053.3333,25318,1608,23710,0
3585,2020-06-23,중구,289888.368,257869.1667,40015,2062,37953,0
3586,2020-06-23,중랑구,347875.7684,282502.5,16180,1286,14894,1
3587,2020-06-24,강남구,865739.3687,643797.9167,55675,4353,51322,1
3588,2020-06-24,강동구,499892.3798,324442.5,20935,1897,19038,0
3589,2020-06-24,강북구,296957.6735,230458.75,13461,1066,12395,0
3590,2020-06-24,강서구,539312.1519,437348.3333,26009,2632,23377,0
3591,2020-06-24,관악구,480415.3692,383285,19710,1903,17807,2
3592,2020-06-24,광진구,365052.7457,277787.0833,18984,1668,17316,0
3593,2020-06-24,구로구,390605.73,355863.3333,22249,1798,20451,1
3594,2020-06-24,금천구,233549.2336,237215,15627,1271,14356,1
3595,2020-06-24,노원구,521685.2244,385263.3333,18235,1866,16369,1
3596,2020-06-24,도봉구,277285.0701,231604.1667,11723,983,10740,1
3597,2020-06-24,동대문구,362631.7389,294331.25,21157,1473,19684,0
3598,2020-06-24,동작구,392884.762,308616.6667,15784,1570,14214,0
3599,2020-06-24,마포구,462023.4222,345919.5833,28401,2400,26001,0
3600,2020-06-24,서대문구,365874.0268,252932.5,15007,1489,13518,0
3601,2020-06-24,서초구,603630.7614,436121.6667,36373,2535,33838,0
3602,2020-06-24,성동구,347744.8078,261468.3333,17062,1322,15740,0
3603,2020-06-24,성북구,431768.5217,338421.25,17151,1584,15567,0
3604,2020-06-24,송파구,743427.8506,517630,37428,3169,34259,0
3605,2020-06-24,양천구,393944.082,315965.4167,18372,1663,16709,0
3606,2020-06-24,영등포구,472668.7875,410403.3333,27173,2259,24914,0
3607,2020-06-24,용산구,290496.3176,216434.5833,18924,1183,17741,0
3608,2020-06-24,은평구,440556.8386,323931.25,18350,1572,16778,0
3609,2020-06-24,종로구,300935.8342,240624.5833,25318,1608,23710,1
3610,2020-06-24,중구,284605.9549,253474.5833,40015,2062,37953,0
3611,2020-06-24,중랑구,349515.7492,285457.5,16180,1286,14894,1
3612,2020-06-25,강남구,868961.3643,646096.6667,55675,4353,51322,0
3613,2020-06-25,강동구,498592.5316,323283.75,20935,1897,19038,0
3614,2020-06-25,강북구,297034.862,230207.5,13461,1066,12395,0
3615,2020-06-25,강서구,539244.6338,437291.6667,26009,2632,23377,1
3616,2020-06-25,관악구,479416.4954,382065.4167,19710,1903,17807,11
3617,2020-06-25,광진구,365427.0052,277293.3333,18984,1668,17316,0
3618,2020-06-25,구로구,390830.1993,355703.3333,22249,1798,20451,1
3619,2020-06-25,금천구,234184.359,237612.9167,15627,1271,14356,0
3620,2020-06-25,노원구,521265.5079,384992.9167,18235,1866,16369,1
3621,2020-06-25,도봉구,277429.9888,231368.75,11723,983,10740,0
3622,2020-06-25,동대문구,363143.0619,293962.0833,21157,1473,19684,0
3623,2020-06-25,동작구,392542.925,307922.0833,15784,1570,14214,1
3624,2020-06-25,마포구,463873.9102,347444.1667,28401,2400,26001,0
3625,2020-06-25,서대문구,365556.8814,252859.5833,15007,1489,13518,0
3626,2020-06-25,서초구,606251.5929,435301.6667,36373,2535,33838,0
3627,2020-06-25,성동구,347091.4368,261088.75,17062,1322,15740,0
3628,2020-06-25,성북구,431014.5159,336764.5833,17151,1584,15567,0
3629,2020-06-25,송파구,744999.8941,516912.5,37428,3169,34259,0
3630,2020-06-25,양천구,393487.8594,315270.4167,18372,1663,16709,0
3631,2020-06-25,영등포구,473895.9218,410775,27173,2259,24914,0
3632,2020-06-25,용산구,291275.4738,217296.6667,18924,1183,17741,0
3633,2020-06-25,은평구,440204.7257,323344.1667,18350,1572,16778,0
3634,2020-06-25,종로구,303488.2371,242296.6667,25318,1608,23710,0
3635,2020-06-25,중구,289438.3876,256870.4167,40015,2062,37953,0
3636,2020-06-25,중랑구,349984.7601,285009.1667,16180,1286,14894,1
3637,2020-06-25,중랑구,349984.7601,285009.1667,16180,1286,14894,1
3638,2020-06-26,강남구,862784.6154,641505.4167,55675,4353,51322,0
3639,2020-06-26,강동구,497253.354,322412.9167,20935,1897,19038,0
3640,2020-06-26,강북구,294651.1721,228348.3333,13461,1066,12395,0
3641,2020-06-26,강서구,534130.198,434680.4167,26009,2632,23377,0
3642,2020-06-26,관악구,473326.3218,378602.5,19710,1903,17807,7
3643,2020-06-26,광진구,366150.8373,278828.3333,18984,1668,17316,1
3644,2020-06-26,구로구,385899.8998,351948.75,22249,1798,20451,1
3645,2020-06-26,금천구,230177.2344,233068.75,15627,1271,14356,0
3646,2020-06-26,노원구,518026.1577,383665.8333,18235,1866,16369,1
3647,2020-06-26,도봉구,275228.2468,229080.4167,11723,983,10740,0
3648,2020-06-26,동대문구,359808.7241,291215,21157,1473,19684,1
3649,2020-06-26,동작구,390755.5391,306807.5,15784,1570,14214,2
3650,2020-06-26,마포구,464738.0934,350071.25,28401,2400,26001,0
3651,2020-06-26,서대문구,360221.2397,250417.5,15007,1489,13518,0
3652,2020-06-26,서초구,603544.7636,436283.75,36373,2535,33838,1
3653,2020-06-26,성동구,345437.7006,259375.8333,17062,1322,15740,0
3654,2020-06-26,성북구,425245.2261,333250.4167,17151,1584,15567,0
3655,2020-06-26,송파구,742707.8584,516478.3333,37428,3169,34259,0
3656,2020-06-26,양천구,391789.0741,314075.4167,18372,1663,16709,0
3657,2020-06-26,영등포구,473306.2875,408990,27173,2259,24914,0
3658,2020-06-26,용산구,293820.4374,218422.9167,18924,1183,17741,0
3659,2020-06-26,은평구,436896.753,321205.4167,18350,1572,16778,1
3660,2020-06-26,종로구,301261.0075,239232.5,25318,1608,23710,0
3661,2020-06-26,중구,286238.0117,253294.5833,40015,2062,37953,1
3662,2020-06-26,중랑구,346179.8494,282952.0833,16180,1286,14894,1
3663,2020-06-27,강남구,743296.17,520542.0833,55675,4353,51322,1
3664,2020-06-27,강동구,504104.1549,331027.0833,20935,1897,19038,0
3665,2020-06-27,강북구,303808.4411,237916.6667,13461,1066,12395,0
3666,2020-06-27,강서구,533647.2104,434950.4167,26009,2632,23377,0
3667,2020-06-27,관악구,490202.7069,395048.3333,19710,1903,17807,5
3668,2020-06-27,광진구,374207.9193,287108.3333,18984,1668,17316,0
3669,2020-06-27,구로구,372649.787,340242.9167,22249,1798,20451,1
3670,2020-06-27,금천구,202607.0831,199192.5,15627,1271,14356,0
3671,2020-06-27,노원구,530989.9111,402372.9167,18235,1866,16369,0
3672,2020-06-27,도봉구,285027.5283,240957.5,11723,983,10740,0
3673,2020-06-27,동대문구,350213.4635,283515,21157,1473,19684,1
3674,2020-06-27,동작구,396687.0093,311477.9167,15784,1570,14214,0
3675,2020-06-27,마포구,452128.9841,332527.0833,28401,2400,26001,1
3676,2020-06-27,서대문구,343660.2308,245024.5833,15007,1489,13518,0
3677,2020-06-27,서초구,540916.7259,375070,36373,2535,33838,0
3678,2020-06-27,성동구,326762.6448,239295,17062,1322,15740,0
3679,2020-06-27,성북구,426675.9666,337135.4167,17151,1584,15567,0
3680,2020-06-27,송파구,730699.5129,504171.6667,37428,3169,34259,1
3681,2020-06-27,양천구,402688.9258,328267.9167,18372,1663,16709,1
3682,2020-06-27,영등포구,424085.355,354027.5,27173,2259,24914,2
3683,2020-06-27,용산구,274602.9085,201308.75,18924,1183,17741,1
3684,2020-06-27,은평구,455298.0422,341388.75,18350,1572,16778,0
3685,2020-06-27,종로구,251087.7527,183690.8333,25318,1608,23710,0
3686,2020-06-27,중구,208207.515,162306.25,40015,2062,37953,0
3687,2020-06-27,중랑구,358147.0884,294419.1667,16180,1286,14894,0
3688,2020-06-28,강남구,692256.6156,475777.0833,55675,4353,51322,0
3689,2020-06-28,강동구,511213.9765,335797.0833,20935,1897,19038,0
3690,2020-06-28,강북구,310995.2587,245175.8333,13461,1066,12395,0
3691,2020-06-28,강서구,539588.2628,439742.0833,26009,2632,23377,0
3692,2020-06-28,관악구,502077.7814,405432.5,19710,1903,17807,1
3693,2020-06-28,광진구,374721.5375,288256.6667,18984,1668,17316,0
3694,2020-06-28,구로구,378197.8373,344281.25,22249,1798,20451,1
3695,2020-06-28,금천구,202293.6246,200489.1667,15627,1271,14356,0
3696,2020-06-28,노원구,537060.4686,408994.5833,18235,1866,16369,1
3697,2020-06-28,도봉구,292476.4038,250927.0833,11723,983,10740,0
3698,2020-06-28,동대문구,348904.7539,281809.1667,21157,1473,19684,0
3699,2020-06-28,동작구,399135.512,314642.0833,15784,1570,14214,0
3700,2020-06-28,마포구,439861.3421,320267.9167,28401,2400,26001,0
3701,2020-06-28,서대문구,342287.2785,245888.3333,15007,1489,13518,0
3702,2020-06-28,서초구,510225.6346,349006.6667,36373,2535,33838,1
3703,2020-06-28,성동구,320516.242,233190.4167,17062,1322,15740,0
3704,2020-06-28,성북구,433118.8191,343534.1667,17151,1584,15567,0
3705,2020-06-28,송파구,725057.0386,500819.1667,37428,3169,34259,1
3706,2020-06-28,양천구,406156.6165,335396.6667,18372,1663,16709,0
3707,2020-06-28,영등포구,414501.6237,344266.6667,27173,2259,24914,0
3708,2020-06-28,용산구,268082.3359,195472.5,18924,1183,17741,1
3709,2020-06-28,은평구,465543.3964,351239.1667,18350,1572,16778,0
3710,2020-06-28,종로구,230836.3849,164860.8333,25318,1608,23710,0
3711,2020-06-28,중구,182850.0378,138353.75,40015,2062,37953,0
3712,2020-06-28,중랑구,364976.0375,301022.0833,16180,1286,14894,1
3713,2020-06-29,강남구,859099.4112,637892.9167,55675,4353,51322,0
3714,2020-06-29,강동구,501538.6381,324253.75,20935,1897,19038,0
3715,2020-06-29,강북구,296481.5034,230051.25,13461,1066,12395,0
3716,2020-06-29,강서구,540895.6785,438230,26009,2632,23377,0
3717,2020-06-29,관악구,478752.1289,380850,19710,1903,17807,0
3718,2020-06-29,광진구,366029.7849,277189.1667,18984,1668,17316,0
3719,2020-06-29,구로구,391126.1275,355880.8333,22249,1798,20451,0
3720,2020-06-29,금천구,233743.3023,239120.4167,15627,1271,14356,1
3721,2020-06-29,노원구,519065.8328,384679.5833,18235,1866,16369,1
3722,2020-06-29,도봉구,278293.6123,231680,11723,983,10740,0
3723,2020-06-29,동대문구,358986.3539,290250.8333,21157,1473,19684,0
3724,2020-06-29,동작구,393731.1292,308502.9167,15784,1570,14214,0
3725,2020-06-29,마포구,459690.4532,344615,28401,2400,26001,3
3726,2020-06-29,서대문구,361587.2366,250607.9167,15007,1489,13518,0
3727,2020-06-29,서초구,597927.3536,431920.8333,36373,2535,33838,0
3728,2020-06-29,성동구,345744.0261,259555.8333,17062,1322,15740,0
3729,2020-06-29,성북구,425373.324,332649.5833,17151,1584,15567,0
3730,2020-06-29,송파구,745309.3619,516695,37428,3169,34259,0
3731,2020-06-29,양천구,395107.1787,316278.3333,18372,1663,16709,0
3732,2020-06-29,영등포구,474101.5084,410806.6667,27173,2259,24914,0
3733,2020-06-29,용산구,287926.5405,214887.9167,18924,1183,17741,0
3734,2020-06-29,은평구,442035.4756,324032.0833,18350,1572,16778,1
3735,2020-06-29,종로구,297828.585,237140.8333,25318,1608,23710,0
3736,2020-06-29,중구,281974.3467,254282.5,40015,2062,37953,0
3737,2020-06-29,중랑구,351606.7009,284281.25,16180,1286,14894,2
3738,2020-06-30,강남구,873463.9647,652807.9167,55675,4353,51322,0
3739,2020-06-30,강동구,503159.4461,327566.6667,20935,1897,19038,0
3740,2020-06-30,강북구,297473.1133,234182.5,13461,1066,12395,0
3741,2020-06-30,강서구,542463.9746,443112.0833,26009,2632,23377,0
3742,2020-06-30,관악구,480062.9391,386315,19710,1903,17807,4
3743,2020-06-30,광진구,366199.6851,281128.3333,18984,1668,17316,0
3744,2020-06-30,구로구,393667.6961,361120.8333,22249,1798,20451,0
3745,2020-06-30,금천구,234908.9862,241167.5,15627,1271,14356,1
3746,2020-06-30,노원구,519673.8019,389244.1667,18235,1866,16369,0
3747,2020-06-30,도봉구,278348.8591,235810.8333,11723,983,10740,0
3748,2020-06-30,동대문구,358158.5416,292687.0833,21157,1473,19684,0
3749,2020-06-30,동작구,394999.6126,310180.4167,15784,1570,14214,0
3750,2020-06-30,마포구,461258.4964,349506.25,28401,2400,26001,1
3751,2020-06-30,서대문구,364208.7848,252275,15007,1489,13518,0
3752,2020-06-30,서초구,602367.3895,437711.25,36373,2535,33838,1
3753,2020-06-30,성동구,348851.2457,264552.0833,17062,1322,15740,0
3754,2020-06-30,성북구,425738.2008,334341.25,17151,1584,15567,0
3755,2020-06-30,송파구,749753.6936,524158.75,37428,3169,34259,0
3756,2020-06-30,양천구,395558.8658,320894.5833,18372,1663,16709,0
3757,2020-06-30,영등포구,478966.0978,418617.9167,27173,2259,24914,2
3758,2020-06-30,용산구,288971.8786,218163.3333,18924,1183,17741,0
3759,2020-06-30,은평구,441864.2626,328752.0833,18350,1572,16778,0
3760,2020-06-30,종로구,303295.1059,242343.3333,25318,1608,23710,0
3761,2020-06-30,중구,287549.0817,259053.3333,40015,2062,37953,0
3762,2020-06-30,중랑구,351405.8943,288650.4167,16180,1286,14894,0
3763,2020-07-01,강남구,877944.0424,652325.8333,55675,4353,51322,0
3764,2020-07-01,강동구,501304.7466,326246.25,20935,1897,19038,2
3765,2020-07-01,강북구,294844.4975,232155.4167,13461,1066,12395,0
3766,2020-07-01,강서구,540440.6527,440424.5833,26009,2632,23377,0
3767,2020-07-01,관악구,476752.5713,383378.3333,19710,1903,17807,7
3768,2020-07-01,광진구,365066.9666,280277.9167,18984,1668,17316,0
3769,2020-07-01,구로구,390101.3969,357940,22249,1798,20451,0
3770,2020-07-01,금천구,233566.2385,238759.1667,15627,1271,14356,0
3771,2020-07-01,노원구,517333.1014,386245.4167,18235,1866,16369,0
3772,2020-07-01,도봉구,277254.017,234029.5833,11723,983,10740,0
3773,2020-07-01,동대문구,358201.3789,290891.6667,21157,1473,19684,1
3774,2020-07-01,동작구,392714.9796,309044.5833,15784,1570,14214,1
3775,2020-07-01,마포구,464513.472,350442.0833,28401,2400,26001,0
3776,2020-07-01,서대문구,362151.7379,251840.8333,15007,1489,13518,0
3777,2020-07-01,서초구,604574.7167,439070,36373,2535,33838,0
3778,2020-07-01,성동구,346689.2622,264062.9167,17062,1322,15740,0
3779,2020-07-01,성북구,423605.6427,332054.5833,17151,1584,15567,0
3780,2020-07-01,송파구,746891.6625,522261.25,37428,3169,34259,0
3781,2020-07-01,양천구,394618.5216,318694.5833,18372,1663,16709,0
3782,2020-07-01,영등포구,478566.3241,416992.0833,27173,2259,24914,0
3783,2020-07-01,용산구,289175.3341,219082.5,18924,1183,17741,0
3784,2020-07-01,은평구,439465.6007,325650.4167,18350,1572,16778,1
3785,2020-07-01,종로구,307194.3514,245107.0833,25318,1608,23710,0
3786,2020-07-01,중구,289746.4193,260049.1667,40015,2062,37953,0
3787,2020-07-01,중랑구,348854.304,286157.0833,16180,1286,14894,1
3788,2020-07-02,강남구,873778.9723,653712.5,55675,4353,51322,1
3789,2020-07-02,강동구,497328.948,324126.25,20935,1897,19038,1
3790,2020-07-02,강북구,293706.6149,230972.5,13461,1066,12395,0
3791,2020-07-02,강서구,537501.8313,438467.5,26009,2632,23377,0
3792,2020-07-02,관악구,474032.2761,381644.1667,19710,1903,17807,1
3793,2020-07-02,광진구,363336.9531,279487.5,18984,1668,17316,0
3794,2020-07-02,구로구,387726.6577,357175.4167,22249,1798,20451,0
3795,2020-07-02,금천구,232040.5161,237265.4167,15627,1271,14356,1
3796,2020-07-02,노원구,513466.2038,383842.0833,18235,1866,16369,1
3797,2020-07-02,도봉구,275820.0708,233130.8333,11723,983,10740,0
3798,2020-07-02,동대문구,355752.119,289456.6667,21157,1473,19684,0
3799,2020-07-02,동작구,389976.491,307877.9167,15784,1570,14214,1
3800,2020-07-02,마포구,463272.8112,350785,28401,2400,26001,1
3801,2020-07-02,서대문구,360801.4532,251394.1667,15007,1489,13518,0
3802,2020-07-02,서초구,603087.4774,438375.4167,36373,2535,33838,1
3803,2020-07-02,성동구,345963.1905,263740.8333,17062,1322,15740,1
3804,2020-07-02,성북구,419833.1954,330469.5833,17151,1584,15567,1
3805,2020-07-02,송파구,742745.1108,519594.1667,37428,3169,34259,0
3806,2020-07-02,양천구,392740.2776,317103.75,18372,1663,16709,0
3807,2020-07-02,영등포구,474381.4435,414710,27173,2259,24914,0
3808,2020-07-02,용산구,290140.6235,218795.8333,18924,1183,17741,0
3809,2020-07-02,은평구,436497.3501,324434.5833,18350,1572,16778,0
3810,2020-07-02,종로구,302230.5807,244188.3333,25318,1608,23710,0
3811,2020-07-02,중구,287806.4167,259599.5833,40015,2062,37953,0
3812,2020-07-02,중랑구,346645.6127,285625,16180,1286,14894,1
3813,2020-07-03,강남구,870965.4561,648089.5833,55675,4353,51322,0
3814,2020-07-03,강동구,497210.7638,324422.5,20935,1897,19038,0
3815,2020-07-03,강북구,293501.0869,230663.3333,13461,1066,12395,0
3816,2020-07-03,강서구,535904.0369,437185,26009,2632,23377,0
3817,2020-07-03,관악구,471837.5934,380507.5,19710,1903,17807,2
3818,2020-07-03,광진구,363461.7269,280124.1667,18984,1668,17316,0
3819,2020-07-03,구로구,385666.4914,354545.8333,22249,1798,20451,1
3820,2020-07-03,금천구,229353.9367,234342.0833,15627,1271,14356,0
3821,2020-07-03,노원구,512684.4172,382687.5,18235,1866,16369,0
3822,2020-07-03,도봉구,275667.627,232131.6667,11723,983,10740,0
3823,2020-07-03,동대문구,353521.56,287635,21157,1473,19684,0
3824,2020-07-03,동작구,389713.5245,307648.75,15784,1570,14214,0
3825,2020-07-03,마포구,466170.407,351802.9167,28401,2400,26001,0
3826,2020-07-03,서대문구,357452.213,250179.5833,15007,1489,13518,0
3827,2020-07-03,서초구,602655.6439,438572.0833,36373,2535,33838,0
3828,2020-07-03,성동구,344818.0791,262240.4167,17062,1322,15740,0
3829,2020-07-03,성북구,417919.3426,328469.1667,17151,1584,15567,0
3830,2020-07-03,송파구,742055.7363,518350.4167,37428,3169,34259,0
3831,2020-07-03,양천구,392044.1836,317548.75,18372,1663,16709,0
3832,2020-07-03,영등포구,473586.469,413290,27173,2259,24914,1
3833,2020-07-03,용산구,289926.9094,219142.5,18924,1183,17741,1
3834,2020-07-03,은평구,435855.7531,322920,18350,1572,16778,0
3835,2020-07-03,종로구,297828.8948,239542.5,25318,1608,23710,1
3836,2020-07-03,중구,285212.7282,253972.5,40015,2062,37953,0
3837,2020-07-03,중랑구,345906.3067,284822.0833,16180,1286,14894,1
3838,2020-07-04,강남구,743495.5783,522215.8333,55675,4353,51322,1
3839,2020-07-04,강동구,501831.0997,332086.25,20935,1897,19038,0
3840,2020-07-04,강북구,303040.4061,241425.8333,13461,1066,12395,0
3841,2020-07-04,강서구,535051.1878,436931.6667,26009,2632,23377,0
3842,2020-07-04,관악구,489351.4376,399084.5833,19710,1903,17807,2
3843,2020-07-04,광진구,371775.2453,289773.3333,18984,1668,17316,0
3844,2020-07-04,구로구,371206.7121,340450,22249,1798,20451,0
3845,2020-07-04,금천구,201777.9607,199782.5,15627,1271,14356,0
3846,2020-07-04,노원구,524955.1026,402433.75,18235,1866,16369,1
3847,2020-07-04,도봉구,285921.7438,245258.75,11723,983,10740,0
3848,2020-07-04,동대문구,346884.2802,282032.0833,21157,1473,19684,0
3849,2020-07-04,동작구,394113.9976,311080,15784,1570,14214,2
3850,2020-07-04,마포구,449264.3569,333764.1667,28401,2400,26001,1
3851,2020-07-04,서대문구,340874.868,244998.75,15007,1489,13518,0
3852,2020-07-04,서초구,535503.0845,374506.6667,36373,2535,33838,1
3853,2020-07-04,성동구,325616.4322,240931.25,17062,1322,15740,0
3854,2020-07-04,성북구,422519.2211,333884.5833,17151,1584,15567,0
3855,2020-07-04,송파구,731023.0005,508104.1667,37428,3169,34259,1
3856,2020-07-04,양천구,400261.0709,331811.25,18372,1663,16709,0
3857,2020-07-04,영등포구,422980.3785,356485,27173,2259,24914,1
3858,2020-07-04,용산구,271509.5779,201788.3333,18924,1183,17741,0
3859,2020-07-04,은평구,455380.0612,344897.5,18350,1572,16778,0
3860,2020-07-04,종로구,250802.7593,184226.25,25318,1608,23710,0
3861,2020-07-04,중구,205763.2711,159400,40015,2062,37953,1
3862,2020-07-04,중랑구,358006.633,296811.6667,16180,1286,14894,5
3863,2020-07-05,강남구,689651.105,476120,55675,4353,51322,0
3864,2020-07-05,강동구,508994.6078,337203.75,20935,1897,19038,0
3865,2020-07-05,강북구,309737.2289,247801.6667,13461,1066,12395,0
3866,2020-07-05,강서구,540851.4676,441800.8333,26009,2632,23377,0
3867,2020-07-05,관악구,500104.1435,408617.5,19710,1903,17807,1
3868,2020-07-05,광진구,370537.3726,290133.75,18984,1668,17316,0
3869,2020-07-05,구로구,376619.7653,345399.5833,22249,1798,20451,0
3870,2020-07-05,금천구,202010.63,200873.3333,15627,1271,14356,0
3871,2020-07-05,노원구,533157.1076,411678.75,18235,1866,16369,0
3872,2020-07-05,도봉구,294028.9514,254639.5833,11723,983,10740,0
3873,2020-07-05,동대문구,346031.4898,281824.1667,21157,1473,19684,0
3874,2020-07-05,동작구,395691.8529,312513.75,15784,1570,14214,0
3875,2020-07-05,마포구,437259.5531,322631.25,28401,2400,26001,0
3876,2020-07-05,서대문구,340444.9141,245364.5833,15007,1489,13518,1
3877,2020-07-05,서초구,507644.9467,350187.9167,36373,2535,33838,0
3878,2020-07-05,성동구,320706.1293,235501.25,17062,1322,15740,0
3879,2020-07-05,성북구,430768.5591,340751.6667,17151,1584,15567,0
3880,2020-07-05,송파구,724275.9813,505205.8333,37428,3169,34259,0
3881,2020-07-05,양천구,404728.6133,338980,18372,1663,16709,0
3882,2020-07-05,영등포구,416000.6304,348088.3333,27173,2259,24914,1
3883,2020-07-05,용산구,266225.6647,196036.6667,18924,1183,17741,0
3884,2020-07-05,은평구,464765.6725,354462.9167,18350,1572,16778,0
3885,2020-07-05,종로구,231026.5883,164068.3333,25318,1608,23710,0
3886,2020-07-05,중구,180068.8455,136355.4167,40015,2062,37953,0
3887,2020-07-05,중랑구,365232.7943,304253.3333,16180,1286,14894,0
3888,2020-07-06,강남구,861994.8066,645306.25,55675,4353,51322,0
3889,2020-07-06,강동구,500392.5519,325871.6667,20935,1897,19038,0
3890,2020-07-06,강북구,295982.4308,232113.3333,13461,1066,12395,0
3891,2020-07-06,강서구,541956.8457,439031.6667,26009,2632,23377,1
3892,2020-07-06,관악구,477233.1114,383250,19710,1903,17807,0
3893,2020-07-06,광진구,362198.0998,279832.9167,18984,1668,17316,0
3894,2020-07-06,구로구,389980.6265,358346.25,22249,1798,20451,0
3895,2020-07-06,금천구,232826.082,239742.0833,15627,1271,14356,0
3896,2020-07-06,노원구,515779.7755,384020.4167,18235,1866,16369,0
3897,2020-07-06,도봉구,277021.3652,234500.4167,11723,983,10740,0
3898,2020-07-06,동대문구,355544.5095,289272.5,21157,1473,19684,0
3899,2020-07-06,동작구,391917.5993,307365.8333,15784,1570,14214,0
3900,2020-07-06,마포구,460400.9598,347795.8333,28401,2400,26001,0
3901,2020-07-06,서대문구,359807.0373,250541.25,15007,1489,13518,0
3902,2020-07-06,서초구,599583.9419,437510,36373,2535,33838,0
3903,2020-07-06,성동구,345076.8984,262126.6667,17062,1322,15740,0
3904,2020-07-06,성북구,422128.3527,330057.0833,17151,1584,15567,0
3905,2020-07-06,송파구,743622.9208,520160.4167,37428,3169,34259,0
3906,2020-07-06,양천구,392763.72,319338.75,18372,1663,16709,0
3907,2020-07-06,영등포구,474461.4346,415227.0833,27173,2259,24914,0
3908,2020-07-06,용산구,285615.0694,215492.9167,18924,1183,17741,0
3909,2020-07-06,은평구,440736.555,325525,18350,1572,16778,0
3910,2020-07-06,종로구,295746.3111,239913.3333,25318,1608,23710,0
3911,2020-07-06,중구,281661.808,255476.6667,40015,2062,37953,0
3912,2020-07-06,중랑구,349366.702,286862.5,16180,1286,14894,1
3913,2020-07-06,중랑구,349366.702,286862.5,16180,1286,14894,1
3914,2020-07-07,강남구,877291.6355,653032.5,55675,4353,51322,0
3915,2020-07-07,강동구,497375.1559,324780,20935,1897,19038,0
3916,2020-07-07,강북구,294748.5571,230767.5,13461,1066,12395,0
3917,2020-07-07,강서구,540777.396,448025,26009,2632,23377,0
3918,2020-07-07,관악구,475970.9517,382381.25,19710,1903,17807,1
3919,2020-07-07,광진구,361440.1645,279077.9167,18984,1668,17316,1
3920,2020-07-07,구로구,388704.3397,339662.5,22249,1798,20451,0
3921,2020-07-07,금천구,232725.6619,255186.25,15627,1271,14356,0
3922,2020-07-07,노원구,513226.5694,382451.25,18235,1866,16369,2
3923,2020-07-07,도봉구,275638.2564,232296.6667,11723,983,10740,0
3924,2020-07-07,동대문구,355984.2138,289240,21157,1473,19684,0
3925,2020-07-07,동작구,391788.0058,307082.5,15784,1570,14214,0
3926,2020-07-07,마포구,462740.9119,349203.3333,28401,2400,26001,4
3927,2020-07-07,서대문구,361279.5085,250480.8333,15007,1489,13518,1
3928,2020-07-07,서초구,605580.5738,440159.5833,36373,2535,33838,0
3929,2020-07-07,성동구,346885.6021,263002.5,17062,1322,15740,0
3930,2020-07-07,성북구,422371.2839,329764.1667,17151,1584,15567,0
3931,2020-07-07,송파구,745427.9502,520742.9167,37428,3169,34259,0
3932,2020-07-07,양천구,391420.1106,307182.9167,18372,1663,16709,0
3933,2020-07-07,영등포구,474713.661,415278.75,27173,2259,24914,0
3934,2020-07-07,용산구,287794.896,216976.25,18924,1183,17741,0
3935,2020-07-07,은평구,438109.1929,323770.4167,18350,1572,16778,0
3936,2020-07-07,종로구,305371.5791,244258.3333,25318,1608,23710,0
3937,2020-07-07,중구,288534.8266,259134.1667,40015,2062,37953,0
3938,2020-07-07,중랑구,346843.0078,285004.5833,16180,1286,14894,1
3939,2020-07-08,강남구,878370.1807,653322.5,55675,4353,51322,0
3940,2020-07-08,강동구,497835.1528,324405.4167,20935,1897,19038,0
3941,2020-07-08,강북구,294346.9575,230576.6667,13461,1066,12395,0
3942,2020-07-08,강서구,540193.4628,437519.5833,26009,2632,23377,0
3943,2020-07-08,관악구,475658.4079,382187.9167,19710,1903,17807,0
3944,2020-07-08,광진구,362321.9352,279412.5,18984,1668,17316,1
3945,2020-07-08,구로구,389062.9136,356258.3333,22249,1798,20451,1
3946,2020-07-08,금천구,232951.5646,237628.3333,15627,1271,14356,0
3947,2020-07-08,노원구,513818.3131,382122.5,18235,1866,16369,1
3948,2020-07-08,도봉구,274871.3632,232354.1667,11723,983,10740,0
3949,2020-07-08,동대문구,355325.9382,288612.9167,21157,1473,19684,0
3950,2020-07-08,동작구,392476.0805,307187.9167,15784,1570,14214,2
3951,2020-07-08,마포구,464108.4738,349587.5,28401,2400,26001,0
3952,2020-07-08,서대문구,360568.1964,250419.1667,15007,1489,13518,1
3953,2020-07-08,서초구,605893.2796,440317.0833,36373,2535,33838,0
3954,2020-07-08,성동구,347460.4697,263085,17062,1322,15740,0
3955,2020-07-08,성북구,420787.7061,329725.8333,17151,1584,15567,0
3956,2020-07-08,송파구,745152.1781,520511.6667,37428,3169,34259,0
3957,2020-07-08,양천구,391554.2786,317308.75,18372,1663,16709,0
3958,2020-07-08,영등포구,476365.608,415663.3333,27173,2259,24914,0
3959,2020-07-08,용산구,288648.3356,217446.25,18924,1183,17741,0
3960,2020-07-08,은평구,437588.6745,323261.25,18350,1572,16778,0
3961,2020-07-08,종로구,306790.9127,245934.1667,25318,1608,23710,0
3962,2020-07-08,중구,288402.5789,258426.6667,40015,2062,37953,1
3963,2020-07-08,중랑구,346613.7728,284652.5,16180,1286,14894,1
3964,2020-07-09,강남구,880457.4261,656222.5,55675,4353,51322,2
3965,2020-07-09,강동구,495801.8503,324134.1667,20935,1897,19038,1
3966,2020-07-09,강북구,292956.07,230168.75,13461,1066,12395,0
3967,2020-07-09,강서구,538653.8643,437153.3333,26009,2632,23377,1
3968,2020-07-09,관악구,475289.7072,381266.6667,19710,1903,17807,0
3969,2020-07-09,광진구,361047.7438,279060.4167,18984,1668,17316,0
3970,2020-07-09,구로구,387038.4925,355148.3333,22249,1798,20451,0
3971,2020-07-09,금천구,231355.832,236600.4167,15627,1271,14356,0
3972,2020-07-09,노원구,511963.5006,381582.9167,18235,1866,16369,0
3973,2020-07-09,도봉구,274612.3568,232222.9167,11723,983,10740,0
3974,2020-07-09,동대문구,354386.8466,288086.6667,21157,1473,19684,0
3975,2020-07-09,동작구,391111.5902,306321.6667,15784,1570,14214,1
3976,2020-07-09,마포구,463270.9727,350086.6667,28401,2400,26001,0
3977,2020-07-09,서대문구,360686.7769,250507.0833,15007,1489,13518,0
3978,2020-07-09,서초구,605912.3571,441821.25,36373,2535,33838,0
3979,2020-07-09,성동구,346693.0913,262551.25,17062,1322,15740,0
3980,2020-07-09,성북구,418447.7354,328565.8333,17151,1584,15567,2
3981,2020-07-09,송파구,741675.0204,519507.5,37428,3169,34259,0
3982,2020-07-09,양천구,390572.0671,317000.8333,18372,1663,16709,0
3983,2020-07-09,영등포구,475245.2752,415637.5,27173,2259,24914,0
3984,2020-07-09,용산구,288579.2017,218092.9167,18924,1183,17741,0
3985,2020-07-09,은평구,436308.4573,322982.9167,18350,1572,16778,0
3986,2020-07-09,종로구,305012.8829,244262.0833,25318,1608,23710,0
3987,2020-07-09,중구,288360.2586,259502.0833,40015,2062,37953,0
3988,2020-07-09,중랑구,346041.0115,283789.5833,16180,1286,14894,1
3989,2020-07-10,강남구,878398.6138,650691.6667,55675,4353,51322,1
3990,2020-07-10,강동구,499741.1541,325232.9167,20935,1897,19038,0
3991,2020-07-10,강북구,293417.7454,231646.25,13461,1066,12395,0
3992,2020-07-10,강서구,539425.8582,437792.0833,26009,2632,23377,1
3993,2020-07-10,관악구,474735.3709,380855.8333,19710,1903,17807,0
3994,2020-07-10,광진구,364081.0383,279942.0833,18984,1668,17316,0
3995,2020-07-10,구로구,388540.187,354755.4167,22249,1798,20451,0
3996,2020-07-10,금천구,230516.164,234392.9167,15627,1271,14356,0
3997,2020-07-10,노원구,516764.111,382344.1667,18235,1866,16369,0
3998,2020-07-10,도봉구,275224.759,232392.0833,11723,983,10740,0
3999,2020-07-10,동대문구,354578.5247,288099.1667,21157,1473,19684,1
4000,2020-07-10,동작구,390979.0654,306179.5833,15784,1570,14214,0
4001,2020-07-10,마포구,465682.0719,350644.1667,28401,2400,26001,0
4002,2020-07-10,서대문구,359801.6447,249616.25,15007,1489,13518,0
4003,2020-07-10,서초구,609084.7205,439928.3333,36373,2535,33838,0
4004,2020-07-10,성동구,347657.1124,260968.3333,17062,1322,15740,0
4005,2020-07-10,성북구,420453.5246,328148.3333,17151,1584,15567,1
4006,2020-07-10,송파구,747448.9159,521041.25,37428,3169,34259,0
4007,2020-07-10,양천구,392000.2594,317887.5,18372,1663,16709,0
4008,2020-07-10,영등포구,476772.8443,414045.8333,27173,2259,24914,1
4009,2020-07-10,용산구,289883.9638,217977.9167,18924,1183,17741,1
4010,2020-07-10,은평구,438827.0906,324288.75,18350,1572,16778,0
4011,2020-07-10,종로구,303765.6154,240282.9167,25318,1608,23710,0
4012,2020-07-10,중구,286369.4676,254180.8333,40015,2062,37953,0
4013,2020-07-10,중랑구,348118.1442,285029.5833,16180,1286,14894,2
4014,2020-07-11,강남구,755285.55,526458.3333,55675,4353,51322,1
4015,2020-07-11,강동구,507272.953,332816.25,20935,1897,19038,2
4016,2020-07-11,강북구,305978.2263,242163.3333,13461,1066,12395,0
4017,2020-07-11,강서구,538053.2361,438377.5,26009,2632,23377,0
4018,2020-07-11,관악구,493172.7552,398675,19710,1903,17807,0
4019,2020-07-11,광진구,374237.5434,290190.8333,18984,1668,17316,0
4020,2020-07-11,구로구,375831.244,340699.5833,22249,1798,20451,0
4021,2020-07-11,금천구,203696.678,200182.9167,15627,1271,14356,0
4022,2020-07-11,노원구,531341.5609,402780.8333,18235,1866,16369,0
4023,2020-07-11,도봉구,287384.5706,244654.1667,11723,983,10740,0
4024,2020-07-11,동대문구,349461.9142,282092.5,21157,1473,19684,0
4025,2020-07-11,동작구,396884.0635,311352.5,15784,1570,14214,1
4026,2020-07-11,마포구,453751.4105,335970.4167,28401,2400,26001,0
4027,2020-07-11,서대문구,345044.0595,245888.3333,15007,1489,13518,0
4028,2020-07-11,서초구,543330.7879,375925.8333,36373,2535,33838,0
4029,2020-07-11,성동구,329915.9283,240738.3333,17062,1322,15740,1
4030,2020-07-11,성북구,424733.6709,333146.25,17151,1584,15567,0
4031,2020-07-11,송파구,738406.2053,509500.8333,37428,3169,34259,0
4032,2020-07-11,양천구,405157.8746,333129.5833,18372,1663,16709,0
4033,2020-07-11,영등포구,428501.6072,358402.5,27173,2259,24914,1
4034,2020-07-11,용산구,275042.6462,203240.8333,18924,1183,17741,0
4035,2020-07-11,은평구,458130.0576,345060.8333,18350,1572,16778,0
4036,2020-07-11,종로구,254963.8915,184527.0833,25318,1608,23710,0
4037,2020-07-11,중구,210299.4061,161364.1667,40015,2062,37953,0
4038,2020-07-11,중랑구,362055.5648,297154.5833,16180,1286,14894,1
4039,2020-07-12,강남구,694700.5558,477162.0833,55675,4353,51322,0
4040,2020-07-12,강동구,514802.077,337596.6667,20935,1897,19038,3
4041,2020-07-12,강북구,313118.3206,248280.8333,13461,1066,12395,0
4042,2020-07-12,강서구,543829.2632,442354.1667,26009,2632,23377,0
4043,2020-07-12,관악구,503453.2199,408621.25,19710,1903,17807,2
4044,2020-07-12,광진구,373444.5731,289699.1667,18984,1668,17316,0
4045,2020-07-12,구로구,379530.4453,344596.6667,22249,1798,20451,0
4046,2020-07-12,금천구,203401.1197,200335,15627,1271,14356,0
4047,2020-07-12,노원구,539270.5405,410370,18235,1866,16369,1
4048,2020-07-12,도봉구,294051.8102,253935.8333,11723,983,10740,0
4049,2020-07-12,동대문구,349617.8172,281817.0833,21157,1473,19684,1
4050,2020-07-12,동작구,398133.8715,312667.9167,15784,1570,14214,1
4051,2020-07-12,마포구,438403.0312,321978.75,28401,2400,26001,2
4052,2020-07-12,서대문구,343842.7749,245433.75,15007,1489,13518,0
4053,2020-07-12,서초구,511222.5733,348362.0833,36373,2535,33838,1
4054,2020-07-12,성동구,323687.0532,234260,17062,1322,15740,0
4055,2020-07-12,성북구,432945.3857,340947.9167,17151,1584,15567,1
4056,2020-07-12,송파구,730165.752,503591.6667,37428,3169,34259,0
4057,2020-07-12,양천구,408752.9191,338937.9167,18372,1663,16709,0
4058,2020-07-12,영등포구,415092.9619,344965.8333,27173,2259,24914,0
4059,2020-07-12,용산구,268043.7361,195981.6667,18924,1183,17741,0
4060,2020-07-12,은평구,468393.8599,355029.1667,18350,1572,16778,0
4061,2020-07-12,종로구,234228.6581,164802.9167,25318,1608,23710,0
4062,2020-07-12,중구,183547.4104,137504.1667,40015,2062,37953,0
4063,2020-07-12,중랑구,368341.0965,303407.9167,16180,1286,14894,1
4064,2020-07-13,강남구,864457.2682,642026.6667,55675,4353,51322,2
4065,2020-07-13,강동구,507594.5358,327043.75,20935,1897,19038,0
4066,2020-07-13,강북구,299972.6604,234035.8333,13461,1066,12395,0
4067,2020-07-13,강서구,546818.6172,441216.6667,26009,2632,23377,0
4068,2020-07-13,관악구,482751.4616,384445.4167,19710,1903,17807,0
4069,2020-07-13,광진구,365724.3305,279822.5,18984,1668,17316,0
4070,2020-07-13,구로구,396412.8676,359743.75,22249,1798,20451,0
4071,2020-07-13,금천구,236133.8721,241072.5,15627,1271,14356,1
4072,2020-07-13,노원구,521764.2384,385197.5,18235,1866,16369,0
4073,2020-07-13,도봉구,280024.1649,236161.6667,11723,983,10740,0
4074,2020-07-13,동대문구,357877.2406,288821.25,21157,1473,19684,0
4075,2020-07-13,동작구,395017.7,309472.5,15784,1570,14214,1
4076,2020-07-13,마포구,460755.3858,346200.4167,28401,2400,26001,0
4077,2020-07-13,서대문구,362412.2729,249737.0833,15007,1489,13518,0
4078,2020-07-13,서초구,603004.1692,433539.1667,36373,2535,33838,0
4079,2020-07-13,성동구,348705.6797,260035.8333,17062,1322,15740,0
4080,2020-07-13,성북구,427062.1778,331409.5833,17151,1584,15567,0
4081,2020-07-13,송파구,750466.3935,520343.75,37428,3169,34259,1
4082,2020-07-13,양천구,396736.9344,321040.4167,18372,1663,16709,0
4083,2020-07-13,영등포구,478662.5887,413590.8333,27173,2259,24914,0
4084,2020-07-13,용산구,285889.5574,214143.75,18924,1183,17741,0
4085,2020-07-13,은평구,447321.5291,328544.5833,18350,1572,16778,1
4086,2020-07-13,종로구,298789.443,235546.25,25318,1608,23710,1
4087,2020-07-13,중구,279107.9695,248713.75,40015,2062,37953,0
4088,2020-07-13,중랑구,355788.3214,289699.5833,16180,1286,14894,0
4089,2020-07-14,강남구,881912.281,652748.75,55675,4353,51322,0
4090,2020-07-14,강동구,502819.6838,324941.6667,20935,1897,19038,1
4091,2020-07-14,강북구,297716.383,231199.5833,13461,1066,12395,0
4092,2020-07-14,강서구,543363.5422,437839.1667,26009,2632,23377,0
4093,2020-07-14,관악구,479410.4457,382137.0833,19710,1903,17807,0
4094,2020-07-14,광진구,363272.2899,277760.4167,18984,1668,17316,0
4095,2020-07-14,구로구,392931.1739,356227.9167,22249,1798,20451,0
4096,2020-07-14,금천구,235341.5631,238210,15627,1271,14356,1
4097,2020-07-14,노원구,518172.5801,382510,18235,1866,16369,0
4098,2020-07-14,도봉구,277393.4204,233162.0833,11723,983,10740,0
4099,2020-07-14,동대문구,358142.9397,288877.5,21157,1473,19684,0
4100,2020-07-14,동작구,393270.5175,307996.25,15784,1570,14214,2
4101,2020-07-14,마포구,464573.0087,349177.9167,28401,2400,26001,0
4102,2020-07-14,서대문구,363541.4898,250177.5,15007,1489,13518,0
4103,2020-07-14,서초구,609148.0415,437758.75,36373,2535,33838,0
4104,2020-07-14,성동구,350259.5536,262389.5833,17062,1322,15740,0
4105,2020-07-14,성북구,424181.578,329045.8333,17151,1584,15567,0
4106,2020-07-14,송파구,752042.7243,520860,37428,3169,34259,1
4107,2020-07-14,양천구,395784.5048,319461.25,18372,1663,16709,0
4108,2020-07-14,영등포구,481797.3559,415557.0833,27173,2259,24914,0
4109,2020-07-14,용산구,288150.7235,215898.3333,18924,1183,17741,0
4110,2020-07-14,은평구,441903.1411,323982.9167,18350,1572,16778,0
4111,2020-07-14,종로구,310076.9837,243943.75,25318,1608,23710,1
4112,2020-07-14,중구,291499.6211,258383.75,40015,2062,37953,0
4113,2020-07-14,중랑구,351065.5232,285534.5833,16180,1286,14894,0
4114,2020-07-15,강남구,882847.0801,653587.5,55675,4353,51322,0
4115,2020-07-15,강동구,500212.9089,323074.5833,20935,1897,19038,1
4116,2020-07-15,강북구,294317.8188,229168.75,13461,1066,12395,1
4117,2020-07-15,강서구,540586.2784,435963.3333,26009,2632,23377,0
4118,2020-07-15,관악구,476849.1696,379850,19710,1903,17807,1
4119,2020-07-15,광진구,362818.2207,277367.0833,18984,1668,17316,0
4120,2020-07-15,구로구,390027.4999,353662.0833,22249,1798,20451,1
4121,2020-07-15,금천구,233641.6294,236605.4167,15627,1271,14356,0
4122,2020-07-15,노원구,514634.7967,380278.75,18235,1866,16369,0
4123,2020-07-15,도봉구,275992.8804,231479.1667,11723,983,10740,0
4124,2020-07-15,동대문구,356226.0202,287522.5,21157,1473,19684,0
4125,2020-07-15,동작구,390932.4022,306917.9167,15784,1570,14214,0
4126,2020-07-15,마포구,465994.5846,350221.6667,28401,2400,26001,0
4127,2020-07-15,서대문구,361122.0033,249225.4167,15007,1489,13518,0
4128,2020-07-15,서초구,610258.5463,439967.9167,36373,2535,33838,0
4129,2020-07-15,성동구,348278.3616,262320.8333,17062,1322,15740,0
4130,2020-07-15,성북구,420263.5015,327024.5833,17151,1584,15567,0
4131,2020-07-15,송파구,748340.519,519160.4167,37428,3169,34259,2
4132,2020-07-15,양천구,392770.9886,316651.25,18372,1663,16709,0
4133,2020-07-15,영등포구,482585.2521,416126.6667,27173,2259,24914,0
4134,2020-07-15,용산구,289431.6969,217655,18924,1183,17741,0
4135,2020-07-15,은평구,438391.1946,321457.9167,18350,1572,16778,0
4136,2020-07-15,종로구,310213.1832,245512.9167,25318,1608,23710,0
4137,2020-07-15,중구,291772.08,258867.9167,40015,2062,37953,1
4138,2020-07-15,중랑구,347741.5639,283233.3333,16180,1286,14894,0
4139,2020-07-16,강남구,883492.5311,651961.6667,55675,4353,51322,0
4140,2020-07-16,강동구,499452.7016,321988.3333,20935,1897,19038,0
4141,2020-07-16,강북구,293998.8313,228865.8333,13461,1066,12395,0
4142,2020-07-16,강서구,538359.7862,435269.1667,26009,2632,23377,0
4143,2020-07-16,관악구,475158.97,378302.5,19710,1903,17807,1
4144,2020-07-16,광진구,363137.8893,277181.25,18984,1668,17316,1
4145,2020-07-16,구로구,388883.6564,353127.9167,22249,1798,20451,0
4146,2020-07-16,금천구,232724.3763,235475.4167,15627,1271,14356,0
4147,2020-07-16,노원구,513273.285,378951.6667,18235,1866,16369,0
4148,2020-07-16,도봉구,275897.1307,231121.25,11723,983,10740,1
4149,2020-07-16,동대문구,355251.0582,285617.0833,21157,1473,19684,0
4150,2020-07-16,동작구,389870.4604,306282.9167,15784,1570,14214,0
4151,2020-07-16,마포구,465672.8194,348995,28401,2400,26001,0
4152,2020-07-16,서대문구,361955.523,248835.8333,15007,1489,13518,1
4153,2020-07-16,서초구,610289.0092,438625.8333,36373,2535,33838,0
4154,2020-07-16,성동구,347489.0316,261254.5833,17062,1322,15740,0
4155,2020-07-16,성북구,419459.0483,325765.4167,17151,1584,15567,0
4156,2020-07-16,송파구,747618.1279,518055,37428,3169,34259,3
4157,2020-07-16,양천구,392374.1449,314681.6667,18372,1663,16709,0
4158,2020-07-16,영등포구,479767.2685,413190,27173,2259,24914,0
4159,2020-07-16,용산구,290274.1119,217391.25,18924,1183,17741,1
4160,2020-07-16,은평구,437439.7906,320873.75,18350,1572,16778,0
4161,2020-07-16,종로구,309890.4973,244197.5,25318,1608,23710,0
4162,2020-07-16,중구,291700.2406,257977.9167,40015,2062,37953,1
4163,2020-07-16,중랑구,347862.9549,282780.8333,16180,1286,14894,0
4164,2020-07-17,강남구,876578.1401,644652.5,55675,4353,51322,1
4165,2020-07-17,강동구,499552.7477,322146.25,20935,1897,19038,0
4166,2020-07-17,강북구,293047.2028,228150,13461,1066,12395,0
4167,2020-07-17,강서구,537829.2447,433697.5,26009,2632,23377,0
4168,2020-07-17,관악구,475397.4112,377635.4167,19710,1903,17807,0
4169,2020-07-17,광진구,365630.3212,278230.4167,18984,1668,17316,0
4170,2020-07-17,구로구,387694.1864,351028.3333,22249,1798,20451,0
4171,2020-07-17,금천구,230020.6388,231945.8333,15627,1271,14356,0
4172,2020-07-17,노원구,513705.9317,379724.5833,18235,1866,16369,0
4173,2020-07-17,도봉구,276094.331,229967.0833,11723,983,10740,0
4174,2020-07-17,동대문구,354597.526,284421.6667,21157,1473,19684,0
4175,2020-07-17,동작구,390029.3649,305573.3333,15784,1570,14214,0
4176,2020-07-17,마포구,467579.2888,349960.8333,28401,2400,26001,1
4177,2020-07-17,서대문구,359118.958,247365.8333,15007,1489,13518,0
4178,2020-07-17,서초구,608675.0051,436096.25,36373,2535,33838,0
4179,2020-07-17,성동구,347955.5111,259712.0833,17062,1322,15740,1
4180,2020-07-17,성북구,418415.5684,324387.5,17151,1584,15567,0
4181,2020-07-17,송파구,746901.318,517492.0833,37428,3169,34259,2
4182,2020-07-17,양천구,392297.9532,315369.1667,18372,1663,16709,0
4183,2020-07-17,영등포구,477641.7442,409215.8333,27173,2259,24914,0
4184,2020-07-17,용산구,291988.7234,218261.6667,18924,1183,17741,0
4185,2020-07-17,은평구,437756.3468,320846.25,18350,1572,16778,1
4186,2020-07-17,종로구,305173.0422,239426.25,25318,1608,23710,0
4187,2020-07-17,중구,287416.1585,249273.75,40015,2062,37953,0
4188,2020-07-17,중랑구,348322.1823,282584.5833,16180,1286,14894,0
4189,2020-07-18,강남구,743325.7339,517555.4167,55675,4353,51322,1
4190,2020-07-18,강동구,504656.9662,330508.3333,20935,1897,19038,0
4191,2020-07-18,강북구,304265.8824,239132.9167,13461,1066,12395,0
4192,2020-07-18,강서구,535917.093,434158.75,26009,2632,23377,0
4193,2020-07-18,관악구,491462.782,395941.25,19710,1903,17807,2
4194,2020-07-18,광진구,373866.0084,288559.5833,18984,1668,17316,0
4195,2020-07-18,구로구,373458.6556,336793.3333,22249,1798,20451,0
4196,2020-07-18,금천구,202522.7605,198795.4167,15627,1271,14356,2
4197,2020-07-18,노원구,527787.6069,400022.0833,18235,1866,16369,0
4198,2020-07-18,도봉구,286622.8712,243435.8333,11723,983,10740,0
4199,2020-07-18,동대문구,347671.92,278919.1667,21157,1473,19684,0
4200,2020-07-18,동작구,394010.5585,310315.4167,15784,1570,14214,0
4201,2020-07-18,마포구,453504.1812,334259.5833,28401,2400,26001,0
4202,2020-07-18,서대문구,342981.0192,243590.8333,15007,1489,13518,0
4203,2020-07-18,서초구,537135.9734,369385.8333,36373,2535,33838,0
4204,2020-07-18,성동구,327632.7945,238469.1667,17062,1322,15740,1
4205,2020-07-18,성북구,421703.8628,329738.3333,17151,1584,15567,0
4206,2020-07-18,송파구,734015.423,505655.4167,37428,3169,34259,3
4207,2020-07-18,양천구,401499.0562,328852.0833,18372,1663,16709,0
4208,2020-07-18,영등포구,425219.5408,353281.25,27173,2259,24914,0
4209,2020-07-18,용산구,274756.1733,202506.6667,18924,1183,17741,0
4210,2020-07-18,은평구,457143.7287,342656.6667,18350,1572,16778,1
4211,2020-07-18,종로구,253361.6889,183342.0833,25318,1608,23710,0
4212,2020-07-18,중구,207337.4176,160687.9167,40015,2062,37953,0
4213,2020-07-18,중랑구,359688.7655,295117.0833,16180,1286,14894,0
4214,2020-07-19,강남구,692449.051,474868.3333,55675,4353,51322,0
4215,2020-07-19,강동구,518853.0828,340242.0833,20935,1897,19038,0
4216,2020-07-19,강북구,314664.7922,248813.75,13461,1066,12395,0
4217,2020-07-19,강서구,548537.0587,445143.75,26009,2632,23377,1
4218,2020-07-19,관악구,506589.6116,409920.4167,19710,1903,17807,0
4219,2020-07-19,광진구,373810.8754,290235.8333,18984,1668,17316,0
4220,2020-07-19,구로구,383869.4755,347963.3333,22249,1798,20451,0
4221,2020-07-19,금천구,205820.0563,202612.9167,15627,1271,14356,0
4222,2020-07-19,노원구,543036.8501,414197.9167,18235,1866,16369,0
4223,2020-07-19,도봉구,295506.0416,254416.25,11723,983,10740,0
4224,2020-07-19,동대문구,351537.0677,283784.5833,21157,1473,19684,0
4225,2020-07-19,동작구,400097.3168,315400.4167,15784,1570,14214,0
4226,2020-07-19,마포구,438515.2349,320581.6667,28401,2400,26001,0
4227,2020-07-19,서대문구,345344.2774,246396.6667,15007,1489,13518,1
4228,2020-07-19,서초구,506893.8585,346185.4167,36373,2535,33838,0
4229,2020-07-19,성동구,325187.8384,235882.9167,17062,1322,15740,0
4230,2020-07-19,성북구,437056.7387,343832.9167,17151,1584,15567,1
4231,2020-07-19,송파구,737026.5407,509126.25,37428,3169,34259,0
4232,2020-07-19,양천구,411963.521,341782.5,18372,1663,16709,0
4233,2020-07-19,영등포구,418517.7131,347447.0833,27173,2259,24914,0
4234,2020-07-19,용산구,270008.3201,197885,18924,1183,17741,0
4235,2020-07-19,은평구,473634.207,357879.1667,18350,1572,16778,0
4236,2020-07-19,종로구,228452.7679,160178.75,25318,1608,23710,0
4237,2020-07-19,중구,180572.4481,136319.1667,40015,2062,37953,0
4238,2020-07-19,중랑구,373506.2224,307387.0833,16180,1286,14894,0
4239,2020-07-20,강남구,864416.9222,640743.75,55675,4353,51322,0
4240,2020-07-20,강동구,505651.1351,325490.8333,20935,1897,19038,1
4241,2020-07-20,강북구,299041.2394,232155.4167,13461,1066,12395,0
4242,2020-07-20,강서구,543828.3868,439043.75,26009,2632,23377,10
4243,2020-07-20,관악구,481543.6667,383247.0833,19710,1903,17807,0
4244,2020-07-20,광진구,364723.0054,279070.8333,18984,1668,17316,1
4245,2020-07-20,구로구,394174.7486,357466.25,22249,1798,20451,0
4246,2020-07-20,금천구,235125.2241,239377.5,15627,1271,14356,1
4247,2020-07-20,노원구,519122.9646,383977.9167,18235,1866,16369,0
4248,2020-07-20,도봉구,279274.2034,234221.25,11723,983,10740,0
4249,2020-07-20,동대문구,357869.5215,288468.3333,21157,1473,19684,0
4250,2020-07-20,동작구,393161.4765,307848.3333,15784,1570,14214,0
4251,2020-07-20,마포구,461655.7032,346055.8333,28401,2400,26001,0
4252,2020-07-20,서대문구,361347.7843,249464.5833,15007,1489,13518,1
4253,2020-07-20,서초구,598203.2803,430515.8333,36373,2535,33838,0
4254,2020-07-20,성동구,347200.0819,260178.3333,17062,1322,15740,2
4255,2020-07-20,성북구,423334.2768,328356.25,17151,1584,15567,1
4256,2020-07-20,송파구,750769.7175,520674.5833,37428,3169,34259,1
4257,2020-07-20,양천구,396152.0792,319859.1667,18372,1663,16709,0
4258,2020-07-20,영등포구,478328.7941,412601.6667,27173,2259,24914,0
4259,2020-07-20,용산구,286143.9053,214080.4167,18924,1183,17741,0
4260,2020-07-20,은평구,446035.0719,326595.8333,18350,1572,16778,1
4261,2020-07-20,종로구,300128.3821,236742.5,25318,1608,23710,1
4262,2020-07-20,중구,282808.2728,252610.4167,40015,2062,37953,1
4263,2020-07-20,중랑구,354082.2084,287259.5833,16180,1286,14894,0
4264,2020-07-21,강남구,882357.2508,654486.6667,55675,4353,51322,0
4265,2020-07-21,강동구,500306.3936,322534.5833,20935,1897,19038,0
4266,2020-07-21,강북구,295197.0753,228909.5833,13461,1066,12395,0
4267,2020-07-21,강서구,539358.2112,435906.25,26009,2632,23377,3
4268,2020-07-21,관악구,476674.9422,379892.0833,19710,1903,17807,0
4269,2020-07-21,광진구,363033.0338,277496.6667,18984,1668,17316,1
4270,2020-07-21,구로구,389976.3856,353931.6667,22249,1798,20451,0
4271,2020-07-21,금천구,233704.2584,236878.75,15627,1271,14356,0
4272,2020-07-21,노원구,515256.009,381299.1667,18235,1866,16369,0
4273,2020-07-21,도봉구,276249.4173,231022.9167,11723,983,10740,0
4274,2020-07-21,동대문구,355827.5069,286642.9167,21157,1473,19684,1
4275,2020-07-21,동작구,391317.1315,306784.5833,15784,1570,14214,1
4276,2020-07-21,마포구,464263.9351,348537.0833,28401,2400,26001,0
4277,2020-07-21,서대문구,361233.6804,248983.3333,15007,1489,13518,0
4278,2020-07-21,서초구,608656.1588,439042.0833,36373,2535,33838,0
4279,2020-07-21,성동구,347517.7465,260606.25,17062,1322,15740,1
4280,2020-07-21,성북구,419794.1255,325751.6667,17151,1584,15567,0
4281,2020-07-21,송파구,748831.7084,518656.6667,37428,3169,34259,5
4282,2020-07-21,양천구,393557.731,316898.75,18372,1663,16709,0
4283,2020-07-21,영등포구,482010.6917,413892.9167,27173,2259,24914,0
4284,2020-07-21,용산구,289082.7043,216756.6667,18924,1183,17741,0
4285,2020-07-21,은평구,440153.5729,322615,18350,1572,16778,3
4286,2020-07-21,종로구,309937.1322,244687.5,25318,1608,23710,1
4287,2020-07-21,중구,291445.1506,258649.5833,40015,2062,37953,1
4288,2020-07-21,중랑구,349181.6646,283643.75,16180,1286,14894,0
4289,2020-07-22,강남구,881158.8356,650167.5,55675,4353,51322,3
4290,2020-07-22,강동구,503333.4126,323672.0833,20935,1897,19038,0
4291,2020-07-22,강북구,296423.0052,229472.0833,13461,1066,12395,0
4292,2020-07-22,강서구,542364.4807,437267.0833,26009,2632,23377,0
4293,2020-07-22,관악구,479974.2719,382017.5,19710,1903,17807,0
4294,2020-07-22,광진구,364397.9231,277635,18984,1668,17316,0
4295,2020-07-22,구로구,392499.3106,354911.25,22249,1798,20451,0
4296,2020-07-22,금천구,234195.3418,236817.5,15627,1271,14356,0
4297,2020-07-22,노원구,517376.936,381778.75,18235,1866,16369,0
4298,2020-07-22,도봉구,276952.8878,231909.5833,11723,983,10740,0
4299,2020-07-22,동대문구,357133.1602,286548.75,21157,1473,19684,1
4300,2020-07-22,동작구,392685.5903,307495.8333,15784,1570,14214,2
4301,2020-07-22,마포구,465301.3342,348219.5833,28401,2400,26001,0
4302,2020-07-22,서대문구,362829.1882,249010,15007,1489,13518,0
4303,2020-07-22,서초구,608090.676,436908.3333,36373,2535,33838,0
4304,2020-07-22,성동구,349014,260973.3333,17062,1322,15740,0
4305,2020-07-22,성북구,422536.1787,326913.3333,17151,1584,15567,0
4306,2020-07-22,송파구,751935.4956,518241.25,37428,3169,34259,5
4307,2020-07-22,양천구,395587.2311,317937.0833,18372,1663,16709,0
4308,2020-07-22,영등포구,482128.0592,412480.8333,27173,2259,24914,0
4309,2020-07-22,용산구,289260.7032,216390,18924,1183,17741,0
4310,2020-07-22,은평구,443166.0343,323553.3333,18350,1572,16778,0
4311,2020-07-22,종로구,308443.4237,243504.1667,25318,1608,23710,0
4312,2020-07-22,중구,288669.3444,254926.25,40015,2062,37953,0
4313,2020-07-22,중랑구,352257.0258,284669.5833,16180,1286,14894,0
4314,2020-07-23,강남구,883556.6909,650238.3333,55675,4353,51322,0
4315,2020-07-23,강동구,503753.9223,323795.8333,20935,1897,19038,0
4316,2020-07-23,강북구,297072.1,230010.8333,13461,1066,12395,0
4317,2020-07-23,강서구,543417.7197,437950.8333,26009,2632,23377,2
4318,2020-07-23,관악구,479738.1903,381375.8333,19710,1903,17807,1
4319,2020-07-23,광진구,365766.477,278328.75,18984,1668,17316,0
4320,2020-07-23,구로구,394768.08,356070.4167,22249,1798,20451,1
4321,2020-07-23,금천구,235583.6345,237745.8333,15627,1271,14356,0
4322,2020-07-23,노원구,518207.0074,382494.1667,18235,1866,16369,0
4323,2020-07-23,도봉구,278532.749,232751.6667,11723,983,10740,1
4324,2020-07-23,동대문구,356125.6866,286713.75,21157,1473,19684,0
4325,2020-07-23,동작구,393055.2671,308027.9167,15784,1570,14214,1
4326,2020-07-23,마포구,465022.3936,347449.5833,28401,2400,26001,0
4327,2020-07-23,서대문구,363783.7991,249369.1667,15007,1489,13518,0
4328,2020-07-23,서초구,610200.1866,438928.3333,36373,2535,33838,0
4329,2020-07-23,성동구,350560.7123,261547.0833,17062,1322,15740,1
4330,2020-07-23,성북구,422862.3534,327775.4167,17151,1584,15567,0
4331,2020-07-23,송파구,750834.073,519015.8333,37428,3169,34259,11
4332,2020-07-23,양천구,395671.4582,318432.9167,18372,1663,16709,0
4333,2020-07-23,영등포구,482123.1446,413992.0833,27173,2259,24914,1
4334,2020-07-23,용산구,290250.916,217326.25,18924,1183,17741,0
4335,2020-07-23,은평구,443634.7356,324312.5,18350,1572,16778,0
4336,2020-07-23,종로구,304763.1452,240452.9167,25318,1608,23710,0
4337,2020-07-23,중구,287795.5585,254711.25,40015,2062,37953,0
4338,2020-07-23,중랑구,353035.2336,285690,16180,1286,14894,2
4339,2020-07-24,강남구,877655.1496,646665,55675,4353,51322,0
4340,2020-07-24,강동구,499271.2969,323230.4167,20935,1897,19038,0
4341,2020-07-24,강북구,297144.116,230673.75,13461,1066,12395,0
4342,2020-07-24,강서구,540207.0265,435277.9167,26009,2632,23377,4
4343,2020-07-24,관악구,477407.2929,380677.9167,19710,1903,17807,0
4344,2020-07-24,광진구,366546.6639,279046.25,18984,1668,17316,0
4345,2020-07-24,구로구,391695.8489,354433.75,22249,1798,20451,0
4346,2020-07-24,금천구,233049.3521,234197.5,15627,1271,14356,1
4347,2020-07-24,노원구,517267.7228,382049.1667,18235,1866,16369,0
4348,2020-07-24,도봉구,277452.5754,231730,11723,983,10740,0
4349,2020-07-24,동대문구,354888.5502,285416.25,21157,1473,19684,0
4350,2020-07-24,동작구,390819.3305,306095,15784,1570,14214,1
4351,2020-07-24,마포구,468735.8961,350539.1667,28401,2400,26001,0
4352,2020-07-24,서대문구,360467.6146,248314.5833,15007,1489,13518,0
4353,2020-07-24,서초구,608398.9898,437265.4167,36373,2535,33838,0
4354,2020-07-24,성동구,348349.4931,259716.25,17062,1322,15740,0
4355,2020-07-24,성북구,419946.2041,325850.8333,17151,1584,15567,0
4356,2020-07-24,송파구,751478.5461,518537.0833,37428,3169,34259,3
4357,2020-07-24,양천구,394295.1731,317954.1667,18372,1663,16709,0
4358,2020-07-24,영등포구,479646.8225,411315,27173,2259,24914,0
4359,2020-07-24,용산구,291009.9682,217467.9167,18924,1183,17741,0
4360,2020-07-24,은평구,441547.9161,323164.1667,18350,1572,16778,2
4361,2020-07-24,종로구,304702.914,238323.3333,25318,1608,23710,0
4362,2020-07-24,중구,286703.8078,252016.25,40015,2062,37953,0
4363,2020-07-24,중랑구,351871.0997,284711.6667,16180,1286,14894,0
4364,2020-07-25,강남구,742560.6392,518225,55675,4353,51322,0
4365,2020-07-25,강동구,505373.5575,331525.4167,20935,1897,19038,0
4366,2020-07-25,강북구,306159.845,240312.5,13461,1066,12395,0
4367,2020-07-25,강서구,535948.6731,435393.75,26009,2632,23377,0
4368,2020-07-25,관악구,490856.2918,397590.8333,19710,1903,17807,0
4369,2020-07-25,광진구,373268.971,288123.75,18984,1668,17316,0
4370,2020-07-25,구로구,374794.5775,339574.5833,22249,1798,20451,0
4371,2020-07-25,금천구,202996.773,199142.5,15627,1271,14356,2
4372,2020-07-25,노원구,529499.5509,402813.3333,18235,1866,16369,0
4373,2020-07-25,도봉구,286149.7171,243675.4167,11723,983,10740,0
4374,2020-07-25,동대문구,349318.4427,281077.5,21157,1473,19684,1
4375,2020-07-25,동작구,394225.9654,310335,15784,1570,14214,0
4376,2020-07-25,마포구,454681.6864,335759.5833,28401,2400,26001,1
4377,2020-07-25,서대문구,342791.8616,243916.25,15007,1489,13518,0
4378,2020-07-25,서초구,535843.3548,370076.25,36373,2535,33838,1
4379,2020-07-25,성동구,327345.0035,238809.5833,17062,1322,15740,0
4380,2020-07-25,성북구,423170.9217,331237.0833,17151,1584,15567,0
4381,2020-07-25,송파구,739386.7938,507673.75,37428,3169,34259,2
4382,2020-07-25,양천구,401330.5749,329370.8333,18372,1663,16709,0
4383,2020-07-25,영등포구,427185.8259,354808.75,27173,2259,24914,0
4384,2020-07-25,용산구,276395.0165,203963.3333,18924,1183,17741,0
4385,2020-07-25,은평구,460360.127,344233.75,18350,1572,16778,0
4386,2020-07-25,종로구,258326.2964,186790.8333,25318,1608,23710,0
4387,2020-07-25,중구,211756.5216,162891.25,40015,2062,37953,0
4388,2020-07-25,중랑구,362008.6643,296480.8333,16180,1286,14894,0
4389,2020-07-26,강남구,685521.4937,470365,55675,4353,51322,1
4390,2020-07-26,강동구,511425.1138,335865.8333,20935,1897,19038,1
4391,2020-07-26,강북구,312469.9732,246429.5833,13461,1066,12395,0
4392,2020-07-26,강서구,539504.0061,438057.5,26009,2632,23377,1
4393,2020-07-26,관악구,500821.0733,406221.25,19710,1903,17807,1
4394,2020-07-26,광진구,372029.1413,287538.75,18984,1668,17316,0
4395,2020-07-26,구로구,379014.6492,342639.1667,22249,1798,20451,0
4396,2020-07-26,금천구,202204.5007,199195,15627,1271,14356,0
4397,2020-07-26,노원구,534877.5913,407949.1667,18235,1866,16369,0
4398,2020-07-26,도봉구,293086.7517,252356.6667,11723,983,10740,0
4399,2020-07-26,동대문구,346443.5191,279298.75,21157,1473,19684,0
4400,2020-07-26,동작구,394555.2248,309363.3333,15784,1570,14214,0
4401,2020-07-26,마포구,441124.3905,321937.9167,28401,2400,26001,1
4402,2020-07-26,서대문구,341793.8829,244150,15007,1489,13518,0
4403,2020-07-26,서초구,504838.2817,343495.4167,36373,2535,33838,0
4404,2020-07-26,성동구,320521.8436,231887.0833,17062,1322,15740,0
4405,2020-07-26,성북구,430535.4387,336870.8333,17151,1584,15567,0
4406,2020-07-26,송파구,728776.6275,499996.6667,37428,3169,34259,1
4407,2020-07-26,양천구,405021.8503,335453.75,18372,1663,16709,0
4408,2020-07-26,영등포구,417014.2493,344568.75,27173,2259,24914,0
4409,2020-07-26,용산구,270734.1898,198361.6667,18924,1183,17741,1
4410,2020-07-26,은평구,468691.3568,353198.75,18350,1572,16778,0
4411,2020-07-26,종로구,236641.7066,166238.75,25318,1608,23710,1
4412,2020-07-26,중구,185401.2683,139118.3333,40015,2062,37953,1
4413,2020-07-26,중랑구,366902.9866,301766.6667,16180,1286,14894,0
4414,2020-07-27,강남구,858612.5064,635051.6667,55675,4353,51322,0
4415,2020-07-27,강동구,499871.9881,322934.5833,20935,1897,19038,0
4416,2020-07-27,강북구,297474.6718,229582.5,13461,1066,12395,1
4417,2020-07-27,강서구,538803.9652,435390.4167,26009,2632,23377,0
4418,2020-07-27,관악구,476759.3702,380013.3333,19710,1903,17807,1
4419,2020-07-27,광진구,362089.5693,276171.6667,18984,1668,17316,0
4420,2020-07-27,구로구,390927.3881,353893.75,22249,1798,20451,0
4421,2020-07-27,금천구,233559.0693,236977.5,15627,1271,14356,2
4422,2020-07-27,노원구,516771.0551,381190.8333,18235,1866,16369,0
4423,2020-07-27,도봉구,276850.5688,232025,11723,983,10740,0
4424,2020-07-27,동대문구,353733.3865,284512.9167,21157,1473,19684,0
4425,2020-07-27,동작구,390684.191,305480,15784,1570,14214,0
4426,2020-07-27,마포구,460972.6566,344125,28401,2400,26001,1
4427,2020-07-27,서대문구,359033.7054,247493.3333,15007,1489,13518,0
4428,2020-07-27,서초구,597250.3548,429746.25,36373,2535,33838,0
4429,2020-07-27,성동구,344548.2244,258309.1667,17062,1322,15740,0
4430,2020-07-27,성북구,421932.229,326972.0833,17151,1584,15567,0
4431,2020-07-27,송파구,745742.0634,514955.4167,37428,3169,34259,0
4432,2020-07-27,양천구,394635.4701,316925,18372,1663,16709,0
4433,2020-07-27,영등포구,476922.3698,409676.6667,27173,2259,24914,0
4434,2020-07-27,용산구,285421.5891,214228.75,18924,1183,17741,0
4435,2020-07-27,은평구,443655.6016,324656.25,18350,1572,16778,0
4436,2020-07-27,종로구,298846.4815,234986.25,25318,1608,23710,0
4437,2020-07-27,중구,281139.3798,250224.5833,40015,2062,37953,0
4438,2020-07-27,중랑구,351980.0216,285340.8333,16180,1286,14894,1
4439,2020-07-28,강남구,872724.4135,645187.9167,55675,4353,51322,0
4440,2020-07-28,강동구,496358.6976,321906.25,20935,1897,19038,0
4441,2020-07-28,강북구,295865.7803,228485.8333,13461,1066,12395,2
4442,2020-07-28,강서구,538687.4807,434299.1667,26009,2632,23377,0
4443,2020-07-28,관악구,475507.0785,378914.1667,19710,1903,17807,1
4444,2020-07-28,광진구,360162.4959,275688.75,18984,1668,17316,0
4445,2020-07-28,구로구,389022.5329,351660.4167,22249,1798,20451,0
4446,2020-07-28,금천구,232474.6348,235251.25,15627,1271,14356,0
4447,2020-07-28,노원구,513060.1759,379300.4167,18235,1866,16369,0
4448,2020-07-28,도봉구,275181.8934,230493.3333,11723,983,10740,0
4449,2020-07-28,동대문구,352585.4454,284409.5833,21157,1473,19684,0
4450,2020-07-28,동작구,389196.6244,304957.5,15784,1570,14214,0
4451,2020-07-28,마포구,462776.1599,346498.3333,28401,2400,26001,1
4452,2020-07-28,서대문구,359563.1638,247276.6667,15007,1489,13518,0
4453,2020-07-28,서초구,601281.0611,433350.8333,36373,2535,33838,0
4454,2020-07-28,성동구,345582.7922,259599.1667,17062,1322,15740,0
4455,2020-07-28,성북구,420767.7752,326168.75,17151,1584,15567,1
4456,2020-07-28,송파구,747438.3032,516067.9167,37428,3169,34259,2
4457,2020-07-28,양천구,390004.7424,315789.1667,18372,1663,16709,0
4458,2020-07-28,영등포구,479637.905,410955.4167,27173,2259,24914,1
4459,2020-07-28,용산구,287599.1421,216201.6667,18924,1183,17741,0
4460,2020-07-28,은평구,439583.7725,322266.25,18350,1572,16778,0
4461,2020-07-28,종로구,305523.2581,240952.0833,25318,1608,23710,0
4462,2020-07-28,중구,288997.381,255505.4167,40015,2062,37953,1
4463,2020-07-28,중랑구,349130.1102,282944.1667,16180,1286,14894,0
4464,2020-07-29,강남구,870324.3907,641933.75,55675,4353,51322,0
4465,2020-07-29,강동구,499558.1129,322705.4167,20935,1897,19038,0
4466,2020-07-29,강북구,298252.7861,229786.6667,13461,1066,12395,0
4467,2020-07-29,강서구,541420.2713,435418.75,26009,2632,23377,0
4468,2020-07-29,관악구,478805.5971,380649.5833,19710,1903,17807,1
4469,2020-07-29,광진구,363115.5908,276712.0833,18984,1668,17316,0
4470,2020-07-29,구로구,391957.0289,354882.0833,22249,1798,20451,1
4471,2020-07-29,금천구,233189.912,234628.75,15627,1271,14356,0
4472,2020-07-29,노원구,515498.5486,380577.0833,18235,1866,16369,0
4473,2020-07-29,도봉구,275689.1536,231535.8333,11723,983,10740,0
4474,2020-07-29,동대문구,353535.2828,284174.5833,21157,1473,19684,0
4475,2020-07-29,동작구,391928.0069,305460.8333,15784,1570,14214,0
4476,2020-07-29,마포구,464385.8734,345594.1667,28401,2400,26001,0
4477,2020-07-29,서대문구,361261.3971,248132.0833,15007,1489,13518,0
4478,2020-07-29,서초구,601130.1035,431726.25,36373,2535,33838,0
4479,2020-07-29,성동구,347377.2784,259182.9167,17062,1322,15740,0
4480,2020-07-29,성북구,422419.0492,327282.0833,17151,1584,15567,1
4481,2020-07-29,송파구,748361.9909,515854.5833,37428,3169,34259,0
4482,2020-07-29,양천구,394136.6062,316861.6667,18372,1663,16709,0
4483,2020-07-29,영등포구,480109.9954,410719.1667,27173,2259,24914,0
4484,2020-07-29,용산구,290183.102,216417.5,18924,1183,17741,0
4485,2020-07-29,은평구,442277.7713,322908.3333,18350,1572,16778,0
4486,2020-07-29,종로구,304890.415,239772.5,25318,1608,23710,0
4487,2020-07-29,중구,285994.2924,251409.5833,40015,2062,37953,0
4488,2020-07-29,중랑구,351482.0102,284363.75,16180,1286,14894,0
4489,2020-07-30,강남구,873972.8665,643937.5,55675,4353,51322,1
4490,2020-07-30,강동구,495668.1535,319714.5833,20935,1897,19038,1
4491,2020-07-30,강북구,295767.8008,227498.75,13461,1066,12395,0
4492,2020-07-30,강서구,537873.8923,432383.75,26009,2632,23377,1
4493,2020-07-30,관악구,474876.1494,377591.6667,19710,1903,17807,2
4494,2020-07-30,광진구,362735.9021,274985,18984,1668,17316,0
4495,2020-07-30,구로구,389466.8581,351437.5,22249,1798,20451,0
4496,2020-07-30,금천구,232426.9978,232485.4167,15627,1271,14356,0
4497,2020-07-30,노원구,511296.7537,376967.0833,18235,1866,16369,0
4498,2020-07-30,도봉구,275162.3684,230056.25,11723,983,10740,0
4499,2020-07-30,동대문구,352426.7401,282284.1667,21157,1473,19684,0
4500,2020-07-30,동작구,388904.6694,302985.4167,15784,1570,14214,0
4501,2020-07-30,마포구,465314.1714,346196.25,28401,2400,26001,0
4502,2020-07-30,서대문구,359105.0903,246481.6667,15007,1489,13518,0
4503,2020-07-30,서초구,600228.7434,429982.5,36373,2535,33838,2
4504,2020-07-30,성동구,345231.9799,257012.9167,17062,1322,15740,0
4505,2020-07-30,성북구,417205.8103,322738.75,17151,1584,15567,0
4506,2020-07-30,송파구,746710.3177,514226.25,37428,3169,34259,1
4507,2020-07-30,양천구,390933.2492,313554.1667,18372,1663,16709,0
4508,2020-07-30,영등포구,480010.8716,408663.75,27173,2259,24914,0
4509,2020-07-30,용산구,291262.5452,216334.1667,18924,1183,17741,0
4510,2020-07-30,은평구,439403.6167,320618.3333,18350,1572,16778,1
4511,2020-07-30,종로구,308352.6612,241859.1667,25318,1608,23710,0
4512,2020-07-30,중구,290900.1767,255309.5833,40015,2062,37953,0
4513,2020-07-30,중랑구,348744.9644,281814.1667,16180,1286,14894,0
4514,2020-07-31,강남구,865439.8781,640822.5,55675,4353,51322,0
4515,2020-07-31,강동구,491152.4494,319868.75,20935,1897,19038,0
4516,2020-07-31,강북구,293948.9491,228486.6667,13461,1066,12395,0
4517,2020-07-31,강서구,530658.1977,431752.5,26009,2632,23377,0
4518,2020-07-31,관악구,470400.3998,377956.25,19710,1903,17807,0
4519,2020-07-31,광진구,360644.9963,277895.4167,18984,1668,17316,0
4520,2020-07-31,구로구,383417.8102,350429.5833,22249,1798,20451,0
4521,2020-07-31,금천구,226490.4202,229410.4167,15627,1271,14356,0
4522,2020-07-31,노원구,506342.9839,379695,18235,1866,16369,0
4523,2020-07-31,도봉구,272687.4203,229590,11723,983,10740,0
4524,2020-07-31,동대문구,347443.4568,282910,21157,1473,19684,0
4525,2020-07-31,동작구,385539.9522,303255.8333,15784,1570,14214,0
4526,2020-07-31,마포구,465543.4725,349206.25,28401,2400,26001,1
4527,2020-07-31,서대문구,354841.9098,247400,15007,1489,13518,0
4528,2020-07-31,서초구,598137.8054,432967.0833,36373,2535,33838,1
4529,2020-07-31,성동구,341472.8665,257838.75,17062,1322,15740,0
4530,2020-07-31,성북구,412046.1353,324983.3333,17151,1584,15567,0
4531,2020-07-31,송파구,737658.351,512414.1667,37428,3169,34259,0
4532,2020-07-31,양천구,388270.0484,312593.75,18372,1663,16709,0
4533,2020-07-31,영등포구,475377.34,407394.1667,27173,2259,24914,0
4534,2020-07-31,용산구,293430.199,219644.5833,18924,1183,17741,0
4535,2020-07-31,은평구,435525.4896,320800.8333,18350,1572,16778,0
4536,2020-07-31,종로구,303945.7645,239680,25318,1608,23710,0
4537,2020-07-31,중구,287896.8286,252760.4167,40015,2062,37953,0
4538,2020-07-31,중랑구,345916.315,282655.4167,16180,1286,14894,0
4539,2020-08-01,강남구,724057.5428,506064.5833,55675,4353,51322,0
4540,2020-08-01,강동구,494948.17,327542.9167,20935,1897,19038,0
4541,2020-08-01,강북구,302794.0381,239236.6667,13461,1066,12395,0
4542,2020-08-01,강서구,528058.0524,432478.75,26009,2632,23377,2
4543,2020-08-01,관악구,485567.2067,395255,19710,1903,17807,0
4544,2020-08-01,광진구,362077.2814,282365,18984,1668,17316,0
4545,2020-08-01,구로구,368074.8444,335072.0833,22249,1798,20451,0
4546,2020-08-01,금천구,199033.0705,196241.25,15627,1271,14356,0
4547,2020-08-01,노원구,521040.9693,401150,18235,1866,16369,0
4548,2020-08-01,도봉구,281288.4404,242892.9167,11723,983,10740,0
4549,2020-08-01,동대문구,340027.2204,276653.75,21157,1473,19684,0
4550,2020-08-01,동작구,387835.5751,306684.1667,15784,1570,14214,0
4551,2020-08-01,마포구,441263.4146,325932.9167,28401,2400,26001,0
4552,2020-08-01,서대문구,337132.1131,242455.8333,15007,1489,13518,0
4553,2020-08-01,서초구,520951.5828,359860.8333,36373,2535,33838,0
4554,2020-08-01,성동구,318204.2881,234095.4167,17062,1322,15740,0
4555,2020-08-01,성북구,417157.3352,332299.5833,17151,1584,15567,0
4556,2020-08-01,송파구,716317.1825,496232.5,37428,3169,34259,0
4557,2020-08-01,양천구,393755.8337,324638.75,18372,1663,16709,1
4558,2020-08-01,영등포구,415368.031,345334.5833,27173,2259,24914,0
4559,2020-08-01,용산구,271557.9284,200555.4167,18924,1183,17741,0
4560,2020-08-01,은평구,452717.0815,341910.8333,18350,1572,16778,0
4561,2020-08-01,종로구,243021.942,175624.5833,25318,1608,23710,1
4562,2020-08-01,중구,201723.7412,153921.25,40015,2062,37953,0
4563,2020-08-01,중랑구,355670.551,295111.25,16180,1286,14894,0
4564,2020-08-02,강남구,675186.6742,463199.5833,55675,4353,51322,0
4565,2020-08-02,강동구,501988.7111,332795.4167,20935,1897,19038,0
4566,2020-08-02,강북구,306364.3567,243310,13461,1066,12395,0
4567,2020-08-02,강서구,533058.2531,436253.3333,26009,2632,23377,1
4568,2020-08-02,관악구,492162.6428,402169.5833,19710,1903,17807,0
4569,2020-08-02,광진구,362064.1433,283066.6667,18984,1668,17316,0
4570,2020-08-02,구로구,371140.7351,338078.3333,22249,1798,20451,0
4571,2020-08-02,금천구,198682.4439,196419.1667,15627,1271,14356,0
4572,2020-08-02,노원구,527421.7541,407917.5,18235,1866,16369,0
4573,2020-08-02,도봉구,285683.4877,249216.6667,11723,983,10740,0
4574,2020-08-02,동대문구,339304.0151,277162.0833,21157,1473,19684,1
4575,2020-08-02,동작구,388951.1998,307597.0833,15784,1570,14214,0
4576,2020-08-02,마포구,427159.6503,313692.0833,28401,2400,26001,0
4577,2020-08-02,서대문구,336921.3217,242278.3333,15007,1489,13518,0
4578,2020-08-02,서초구,497476.5438,339974.5833,36373,2535,33838,0
4579,2020-08-02,성동구,314888.5154,230864.1667,17062,1322,15740,0
4580,2020-08-02,성북구,424352.5887,337370.8333,17151,1584,15567,1
4581,2020-08-02,송파구,715599.2302,495603.75,37428,3169,34259,0
4582,2020-08-02,양천구,397684.4056,329863.3333,18372,1663,16709,0
4583,2020-08-02,영등포구,408567.3483,338890.8333,27173,2259,24914,0
4584,2020-08-02,용산구,267617.4321,196679.5833,18924,1183,17741,1
4585,2020-08-02,은평구,462340.7459,349221.6667,18350,1572,16778,0
4586,2020-08-02,종로구,222969.1552,157398.75,25318,1608,23710,0
4587,2020-08-02,중구,178594.6025,135303.3333,40015,2062,37953,0
4588,2020-08-02,중랑구,362303.855,301136.25,16180,1286,14894,1
4589,2020-08-03,강남구,841278.0917,619452.5,55675,4353,51322,0
4590,2020-08-03,강동구,490782.5529,321906.25,20935,1897,19038,0
4591,2020-08-03,강북구,294038.3156,230952.9167,13461,1066,12395,0
4592,2020-08-03,강서구,531684.6943,433880,26009,2632,23377,2
4593,2020-08-03,관악구,470238.5788,378360.4167,19710,1903,17807,1
4594,2020-08-03,광진구,355810.8823,275937.9167,18984,1668,17316,0
4595,2020-08-03,구로구,383273.4589,347920.8333,22249,1798,20451,0
4596,2020-08-03,금천구,225603.2712,228077.9167,15627,1271,14356,0
4597,2020-08-03,노원구,511652.65,384477.9167,18235,1866,16369,0
4598,2020-08-03,도봉구,272205.6536,233525,11723,983,10740,1
4599,2020-08-03,동대문구,344123.0518,281214.1667,21157,1473,19684,0
4600,2020-08-03,동작구,383317.009,302160.8333,15784,1570,14214,0
4601,2020-08-03,마포구,451004.9672,338840.4167,28401,2400,26001,1
4602,2020-08-03,서대문구,356400.1839,246826.6667,15007,1489,13518,0
4603,2020-08-03,서초구,585184.1243,417472.9167,36373,2535,33838,0
4604,2020-08-03,성동구,336007.3735,253061.6667,17062,1322,15740,0
4605,2020-08-03,성북구,414353.4945,326307.9167,17151,1584,15567,1
4606,2020-08-03,송파구,735730.1087,512170.8333,37428,3169,34259,1
4607,2020-08-03,양천구,386785.9304,313345,18372,1663,16709,0
4608,2020-08-03,영등포구,467339.0221,400352.5,27173,2259,24914,0
4609,2020-08-03,용산구,280765.7035,209687.0833,18924,1183,17741,0
4610,2020-08-03,은평구,438465.9767,324251.25,18350,1572,16778,0
4611,2020-08-03,종로구,278289.7292,215094.1667,25318,1608,23710,0
4612,2020-08-03,중구,268343.1432,237113.3333,40015,2062,37953,2
4613,2020-08-03,중랑구,348590.1912,286585.4167,16180,1286,14894,0
4614,2020-08-04,강남구,867184.8663,634266.25,55675,4353,51322,0
4615,2020-08-04,강동구,491087.7107,322269.5833,20935,1897,19038,0
4616,2020-08-04,강북구,294154.5039,231129.1667,13461,1066,12395,0
4617,2020-08-04,강서구,532086.926,434865.8333,26009,2632,23377,0
4618,2020-08-04,관악구,469212.7815,380342.9167,19710,1903,17807,0
4619,2020-08-04,광진구,357661.2535,276866.25,18984,1668,17316,0
4620,2020-08-04,구로구,385476.2386,350515,22249,1798,20451,0
4621,2020-08-04,금천구,227324.8934,229381.25,15627,1271,14356,0
4622,2020-08-04,노원구,509378.3266,383378.75,18235,1866,16369,0
4623,2020-08-04,도봉구,271726.236,232821.6667,11723,983,10740,1
4624,2020-08-04,동대문구,347139.7572,283489.1667,21157,1473,19684,0
4625,2020-08-04,동작구,383783.8735,303770.8333,15784,1570,14214,0
4626,2020-08-04,마포구,457320.4602,342542.9167,28401,2400,26001,0
4627,2020-08-04,서대문구,357855.7111,248253.3333,15007,1489,13518,0
4628,2020-08-04,서초구,595933.5488,422893.3333,36373,2535,33838,0
4629,2020-08-04,성동구,339957.0134,256060,17062,1322,15740,0
4630,2020-08-04,성북구,413751.7075,326948.3333,17151,1584,15567,1
4631,2020-08-04,송파구,741685.4817,515087.9167,37428,3169,34259,1
4632,2020-08-04,양천구,388424.264,315069.5833,18372,1663,16709,0
4633,2020-08-04,영등포구,475165.2908,404512.5,27173,2259,24914,1
4634,2020-08-04,용산구,284262.1054,212848.75,18924,1183,17741,0
4635,2020-08-04,은평구,436349.0735,323676.25,18350,1572,16778,2
4636,2020-08-04,종로구,290859.513,223926.25,25318,1608,23710,0
4637,2020-08-04,중구,279980.4756,243160.4167,40015,2062,37953,0
4638,2020-08-04,중랑구,346282.4878,285718.3333,16180,1286,14894,0
4639,2020-08-05,강남구,864234.669,637129.1667,55675,4353,51322,0
4640,2020-08-05,강동구,496262.4474,324142.9167,20935,1897,19038,0
4641,2020-08-05,강북구,297609.5976,231976.6667,13461,1066,12395,0
4642,2020-08-05,강서구,536510.6069,437559.5833,26009,2632,23377,0
4643,2020-08-05,관악구,473422.1831,381536.25,19710,1903,17807,0
4644,2020-08-05,광진구,360265.2918,278327.5,18984,1668,17316,0
4645,2020-08-05,구로구,388861.8723,355150.4167,22249,1798,20451,0
4646,2020-08-05,금천구,228843.0304,231433.75,15627,1271,14356,0
4647,2020-08-05,노원구,514304.4357,385378.75,18235,1866,16369,0
4648,2020-08-05,도봉구,275182.21,234380.8333,11723,983,10740,0
4649,2020-08-05,동대문구,349100.6716,285012.5,21157,1473,19684,1
4650,2020-08-05,동작구,387012.8308,305247.5,15784,1570,14214,0
4651,2020-08-05,마포구,459319.5211,344459.5833,28401,2400,26001,0
4652,2020-08-05,서대문구,358416.7416,248927.0833,15007,1489,13518,0
4653,2020-08-05,서초구,596028.6014,426127.0833,36373,2535,33838,2
4654,2020-08-05,성동구,342849.9815,258230.4167,17062,1322,15740,2
4655,2020-08-05,성북구,417570.8478,329335.4167,17151,1584,15567,0
4656,2020-08-05,송파구,747163.4714,518311.25,37428,3169,34259,0
4657,2020-08-05,양천구,392950.3978,316589.5833,18372,1663,16709,0
4658,2020-08-05,영등포구,475966.3018,408604.5833,27173,2259,24914,0
4659,2020-08-05,용산구,288787.3338,217447.9167,18924,1183,17741,2
4660,2020-08-05,은평구,441032.949,325158.3333,18350,1572,16778,0
4661,2020-08-05,종로구,290617.0195,226409.5833,25318,1608,23710,0
4662,2020-08-05,중구,277673.6191,245266.25,40015,2062,37953,0
4663,2020-08-05,중랑구,349648.6655,287665.4167,16180,1286,14894,2
4664,2020-08-06,강남구,864640.2786,636765.4167,55675,4353,51322,0
4665,2020-08-06,강동구,496301.4286,323039.1667,20935,1897,19038,0
4666,2020-08-06,강북구,296031.2885,230796.6667,13461,1066,12395,0
4667,2020-08-06,강서구,535524.8269,436511.25,26009,2632,23377,0
4668,2020-08-06,관악구,474779.9893,382526.6667,19710,1903,17807,0
4669,2020-08-06,광진구,361889.1461,279782.0833,18984,1668,17316,0
4670,2020-08-06,구로구,390856.022,357972.0833,22249,1798,20451,0
4671,2020-08-06,금천구,230896.0801,232882.0833,15627,1271,14356,0
4672,2020-08-06,노원구,513186.5422,383375.8333,18235,1866,16369,0
4673,2020-08-06,도봉구,273499.1532,232319.5833,11723,983,10740,2
4674,2020-08-06,동대문구,350816.586,286192.5,21157,1473,19684,0
4675,2020-08-06,동작구,388461.1331,306002.9167,15784,1570,14214,0
4676,2020-08-06,마포구,461673.463,347204.5833,28401,2400,26001,2
4677,2020-08-06,서대문구,358327.6013,250016.25,15007,1489,13518,0
4678,2020-08-06,서초구,595272.6759,426573.3333,36373,2535,33838,0
4679,2020-08-06,성동구,343019.0286,259591.6667,17062,1322,15740,1
4680,2020-08-06,성북구,416183.2759,327972.0833,17151,1584,15567,1
4681,2020-08-06,송파구,746215.6538,517009.1667,37428,3169,34259,0
4682,2020-08-06,양천구,393988.8371,318002.5,18372,1663,16709,0
4683,2020-08-06,영등포구,474327.3568,407992.5,27173,2259,24914,0
4684,2020-08-06,용산구,292717.0089,219915,18924,1183,17741,2
4685,2020-08-06,은평구,440421.5695,324070.4167,18350,1572,16778,0
4686,2020-08-06,종로구,301912.631,239261.6667,25318,1608,23710,0
4687,2020-08-06,중구,285536.9188,252211.6667,40015,2062,37953,0
4688,2020-08-06,중랑구,350394.15,286947.0833,16180,1286,14894,1
4689,2020-08-07,강남구,868026.2903,636897.5,55675,4353,51322,3
4690,2020-08-07,강동구,493508.2889,322172.9167,20935,1897,19038,0
4691,2020-08-07,강북구,294078.74,229123.3333,13461,1066,12395,0
4692,2020-08-07,강서구,533733.3082,433825.8333,26009,2632,23377,1
4693,2020-08-07,관악구,472779.6102,379583.3333,19710,1903,17807,0
4694,2020-08-07,광진구,361227.2308,278476.25,18984,1668,17316,0
4695,2020-08-07,구로구,387928.7909,354092.9167,22249,1798,20451,0
4696,2020-08-07,금천구,227446.0572,229167.9167,15627,1271,14356,0
4697,2020-08-07,노원구,510284.4202,381761.6667,18235,1866,16369,0
4698,2020-08-07,도봉구,272133.7723,230006.25,11723,983,10740,1
4699,2020-08-07,동대문구,350473.9569,284337.5,21157,1473,19684,0
4700,2020-08-07,동작구,385890.043,303120,15784,1570,14214,2
4701,2020-08-07,마포구,465899.9101,350261.25,28401,2400,26001,1
4702,2020-08-07,서대문구,355822.3514,246837.0833,15007,1489,13518,0
4703,2020-08-07,서초구,596399.7292,427227.9167,36373,2535,33838,2
4704,2020-08-07,성동구,343867.1013,258004.5833,17062,1322,15740,1
4705,2020-08-07,성북구,411019.9353,324302.5,17151,1584,15567,2
4706,2020-08-07,송파구,748434.2937,517393.75,37428,3169,34259,0
4707,2020-08-07,양천구,391560.4235,315185,18372,1663,16709,0
4708,2020-08-07,영등포구,473310.2861,407513.3333,27173,2259,24914,1
4709,2020-08-07,용산구,292712.7239,220040.4167,18924,1183,17741,1
4710,2020-08-07,은평구,435318.6175,321158.75,18350,1572,16778,0
4711,2020-08-07,종로구,306120.6808,239378.75,25318,1608,23710,0
4712,2020-08-07,중구,287595.4073,251677.0833,40015,2062,37953,0
4713,2020-08-07,중랑구,347593.5,284807.5,16180,1286,14894,2
4714,2020-08-08,강남구,747743.1925,521372.5,55675,4353,51322,0
4715,2020-08-08,강동구,502682.452,333859.5833,20935,1897,19038,0
4716,2020-08-08,강북구,305044.8174,241052.9167,13461,1066,12395,0
4717,2020-08-08,강서구,535121.2504,441303.75,26009,2632,23377,0
4718,2020-08-08,관악구,492520.4996,401244.1667,19710,1903,17807,0
4719,2020-08-08,광진구,369699.1053,289004.5833,18984,1668,17316,1
4720,2020-08-08,구로구,377359.8401,345561.6667,22249,1798,20451,0
4721,2020-08-08,금천구,203347.5135,201028.3333,15627,1271,14356,1
4722,2020-08-08,노원구,527892.0007,405694.1667,18235,1866,16369,0
4723,2020-08-08,도봉구,283075.8932,244791.25,11723,983,10740,1
4724,2020-08-08,동대문구,347459.3901,283640.4167,21157,1473,19684,0
4725,2020-08-08,동작구,391905.182,311235.8333,15784,1570,14214,0
4726,2020-08-08,마포구,449866.6282,332424.5833,28401,2400,26001,1
4727,2020-08-08,서대문구,341096.3417,245411.25,15007,1489,13518,1
4728,2020-08-08,서초구,530429.1155,368320.4167,36373,2535,33838,0
4729,2020-08-08,성동구,326228.884,239875.8333,17062,1322,15740,0
4730,2020-08-08,성북구,417372.1141,332839.1667,17151,1584,15567,3
4731,2020-08-08,송파구,742378.9219,513099.1667,37428,3169,34259,0
4732,2020-08-08,양천구,403450.9614,331972.9167,18372,1663,16709,0
4733,2020-08-08,영등포구,422077.0745,353867.5,27173,2259,24914,0
4734,2020-08-08,용산구,275529.2678,204796.25,18924,1183,17741,0
4735,2020-08-08,은평구,456745.33,344876.6667,18350,1572,16778,1
4736,2020-08-08,종로구,252147.7895,182543.3333,25318,1608,23710,1
4737,2020-08-08,중구,207020.8301,159867.5,40015,2062,37953,0
4738,2020-08-08,중랑구,361344.9067,300359.1667,16180,1286,14894,3
4739,2020-08-09,강남구,694194.3144,475020.8333,55675,4353,51322,0
4740,2020-08-09,강동구,515440.8674,340952.9167,20935,1897,19038,0
4741,2020-08-09,강북구,313747.7345,248287.9167,13461,1066,12395,0
4742,2020-08-09,강서구,544723.7687,448735.4167,26009,2632,23377,0
4743,2020-08-09,관악구,505763.8745,414069.1667,19710,1903,17807,1
4744,2020-08-09,광진구,371674.8765,291295,18984,1668,17316,1
4745,2020-08-09,구로구,383855.7155,352617.5,22249,1798,20451,2
4746,2020-08-09,금천구,204692.2261,203141.6667,15627,1271,14356,0
4747,2020-08-09,노원구,535969.9013,414792.9167,18235,1866,16369,1
4748,2020-08-09,도봉구,290944.2561,255442.5,11723,983,10740,0
4749,2020-08-09,동대문구,347666.3551,284994.1667,21157,1473,19684,1
4750,2020-08-09,동작구,397606.1726,315514.1667,15784,1570,14214,0
4751,2020-08-09,마포구,432589.7959,318596.25,28401,2400,26001,1
4752,2020-08-09,서대문구,343888.2147,248283.75,15007,1489,13518,1
4753,2020-08-09,서초구,502288.5152,345220.8333,36373,2535,33838,0
4754,2020-08-09,성동구,320963.6005,235821.6667,17062,1322,15740,0
4755,2020-08-09,성북구,429102.7618,343352.9167,17151,1584,15567,0
4756,2020-08-09,송파구,737343.3644,511600.4167,37428,3169,34259,1
4757,2020-08-09,양천구,411025.656,342167.0833,18372,1663,16709,0
4758,2020-08-09,영등포구,414600.27,346697.9167,27173,2259,24914,0
4759,2020-08-09,용산구,270646.7519,200174.5833,18924,1183,17741,1
4760,2020-08-09,은평구,470224.3652,357739.5833,18350,1572,16778,1
4761,2020-08-09,종로구,224383.921,157734.5833,25318,1608,23710,0
4762,2020-08-09,중구,175594.7093,133605.4167,40015,2062,37953,1
4763,2020-08-09,중랑구,372388.4531,310124.1667,16180,1286,14894,1
4764,2020-08-10,강남구,860976.2193,637093.75,55675,4353,51322,0
4765,2020-08-10,강동구,496366.9311,322280,20935,1897,19038,0
4766,2020-08-10,강북구,296012.9249,229426.6667,13461,1066,12395,0
4767,2020-08-10,강서구,536590.0736,437410.8333,26009,2632,23377,0
4768,2020-08-10,관악구,476367.3203,382166.6667,19710,1903,17807,0
4769,2020-08-10,광진구,361180.3664,278457.0833,18984,1668,17316,0
4770,2020-08-10,구로구,390705.5063,357402.5,22249,1798,20451,0
4771,2020-08-10,금천구,232886.4807,237323.75,15627,1271,14356,0
4772,2020-08-10,노원구,512351.7311,383392.5,18235,1866,16369,0
4773,2020-08-10,도봉구,274165.2457,233190.4167,11723,983,10740,0
4774,2020-08-10,동대문구,350871.233,284945,21157,1473,19684,0
4775,2020-08-10,동작구,388507.3923,305131.6667,15784,1570,14214,1
4776,2020-08-10,마포구,455778.6158,342162.5,28401,2400,26001,0
4777,2020-08-10,서대문구,356322.7753,248006.6667,15007,1489,13518,0
4778,2020-08-10,서초구,595411.1116,429718.75,36373,2535,33838,1
4779,2020-08-10,성동구,343082.5241,257165.8333,17062,1322,15740,0
4780,2020-08-10,성북구,412503.2837,324440.8333,17151,1584,15567,0
4781,2020-08-10,송파구,745779.8069,517716.6667,37428,3169,34259,0
4782,2020-08-10,양천구,394198.3031,317085,18372,1663,16709,2
4783,2020-08-10,영등포구,473501.0593,407948.75,27173,2259,24914,1
4784,2020-08-10,용산구,285116.1947,214107.9167,18924,1183,17741,0
4785,2020-08-10,은평구,441338.9744,324718.3333,18350,1572,16778,0
4786,2020-08-10,종로구,290850.7043,230344.1667,25318,1608,23710,0
4787,2020-08-10,중구,256863.5998,232897.9167,40015,2062,37953,0
4788,2020-08-10,중랑구,351544.5532,287604.5833,16180,1286,14894,1
4789,2020-08-11,강남구,874184.1283,643105.8333,55675,4353,51322,1
4790,2020-08-11,강동구,497228.8153,323479.5833,20935,1897,19038,0
4791,2020-08-11,강북구,295573.6821,229722.9167,13461,1066,12395,1
4792,2020-08-11,강서구,535947.0049,436737.5,26009,2632,23377,0
4793,2020-08-11,관악구,476460.3168,381633.3333,19710,1903,17807,1
4794,2020-08-11,광진구,361304.0141,277598.3333,18984,1668,17316,0
4795,2020-08-11,구로구,391645.9853,357119.1667,22249,1798,20451,0
4796,2020-08-11,금천구,233247.7617,236059.5833,15627,1271,14356,2
4797,2020-08-11,노원구,511533.2145,382923.3333,18235,1866,16369,0
4798,2020-08-11,도봉구,273672.5414,231724.5833,11723,983,10740,1
4799,2020-08-11,동대문구,350386.2458,285819.1667,21157,1473,19684,0
4800,2020-08-11,동작구,389320.6938,305495.8333,15784,1570,14214,2
4801,2020-08-11,마포구,461628.3915,345149.5833,28401,2400,26001,0
4802,2020-08-11,서대문구,358718.5695,249348.3333,15007,1489,13518,0
4803,2020-08-11,서초구,601211.2025,432159.5833,36373,2535,33838,1
4804,2020-08-11,성동구,344971.9563,258556.25,17062,1322,15740,1
4805,2020-08-11,성북구,413234.8934,324717.5,17151,1584,15567,0
4806,2020-08-11,송파구,747021.9957,517733.3333,37428,3169,34259,0
4807,2020-08-11,양천구,392860.5918,317415.8333,18372,1663,16709,0
4808,2020-08-11,영등포구,479226.2643,409205.8333,27173,2259,24914,1
4809,2020-08-11,용산구,287119.9614,214962.9167,18924,1183,17741,0
4810,2020-08-11,은평구,438987.3698,322827.9167,18350,1572,16778,3
4811,2020-08-11,종로구,298163.8118,235430,25318,1608,23710,0
4812,2020-08-11,중구,264464.1499,237192.0833,40015,2062,37953,0
4813,2020-08-11,중랑구,351148.6288,286997.0833,16180,1286,14894,1
4814,2020-08-12,강남구,879826.413,647016.6667,55675,4353,51322,0
4815,2020-08-12,강동구,497655.5382,320774.1667,20935,1897,19038,0
4816,2020-08-12,강북구,293063.1199,227890.8333,13461,1066,12395,0
4817,2020-08-12,강서구,535004.3827,435015.8333,26009,2632,23377,3
4818,2020-08-12,관악구,472896.7603,378790.4167,19710,1903,17807,1
4819,2020-08-12,광진구,358819.1995,276693.75,18984,1668,17316,2
4820,2020-08-12,구로구,389492.2095,354749.1667,22249,1798,20451,0
4821,2020-08-12,금천구,231415.8887,233683.3333,15627,1271,14356,2
4822,2020-08-12,노원구,507939.2993,380982.5,18235,1866,16369,1
4823,2020-08-12,도봉구,272229.3546,229725.4167,11723,983,10740,0
4824,2020-08-12,동대문구,347792.9947,284050.8333,21157,1473,19684,0
4825,2020-08-12,동작구,387710.0074,303987.5,15784,1570,14214,0
4826,2020-08-12,마포구,465055.6775,346531.25,28401,2400,26001,0
4827,2020-08-12,서대문구,357766.6271,248670,15007,1489,13518,0
4828,2020-08-12,서초구,604006.1012,435305.8333,36373,2535,33838,2
4829,2020-08-12,성동구,347556.4498,259039.1667,17062,1322,15740,1
4830,2020-08-12,성북구,409412.1412,322217.9167,17151,1584,15567,2
4831,2020-08-12,송파구,746886.1995,516839.5833,37428,3169,34259,0
4832,2020-08-12,양천구,389391.9958,314710,18372,1663,16709,2
4833,2020-08-12,영등포구,478665.7921,408204.5833,27173,2259,24914,0
4834,2020-08-12,용산구,289154.306,216726.6667,18924,1183,17741,1
4835,2020-08-12,은평구,436234.0499,320027.5,18350,1572,16778,4
4836,2020-08-12,종로구,305929.6324,239737.9167,25318,1608,23710,1
4837,2020-08-12,중구,268462.2709,239123.3333,40015,2062,37953,2
4838,2020-08-12,중랑구,346767.2333,283725.4167,16180,1286,14894,2
4839,2020-08-13,강남구,878452.9418,644832.9167,55675,4353,51322,0
4840,2020-08-13,강동구,493279.1997,318594.5833,20935,1897,19038,0
4841,2020-08-13,강북구,289997.912,226960,13461,1066,12395,1
4842,2020-08-13,강서구,534475.4924,433621.25,26009,2632,23377,2
4843,2020-08-13,관악구,470905.7328,377162.5,19710,1903,17807,1
4844,2020-08-13,광진구,356750.5485,275117.5,18984,1668,17316,6
4845,2020-08-13,구로구,386985.5333,352782.0833,22249,1798,20451,0
4846,2020-08-13,금천구,230211.8427,232494.1667,15627,1271,14356,1
4847,2020-08-13,노원구,507483.9928,378768.75,18235,1866,16369,0
4848,2020-08-13,도봉구,271957.2157,228863.3333,11723,983,10740,1
4849,2020-08-13,동대문구,350322.9103,283132.5,21157,1473,19684,2
4850,2020-08-13,동작구,386379.7657,303165.8333,15784,1570,14214,2
4851,2020-08-13,마포구,464074.6045,346038.3333,28401,2400,26001,0
4852,2020-08-13,서대문구,359001.6836,248064.1667,15007,1489,13518,1
4853,2020-08-13,서초구,603748.9149,434396.6667,36373,2535,33838,4
4854,2020-08-13,성동구,345646.1705,258844.1667,17062,1322,15740,0
4855,2020-08-13,성북구,410898.1597,321422.0833,17151,1584,15567,7
4856,2020-08-13,송파구,743571.7427,513729.1667,37428,3169,34259,0
4857,2020-08-13,양천구,388000.2615,313525.8333,18372,1663,16709,1
4858,2020-08-13,영등포구,475947.011,406628.75,27173,2259,24914,0
4859,2020-08-13,용산구,290974.3211,217881.25,18924,1183,17741,0
4860,2020-08-13,은평구,432671.6634,319132.9167,18350,1572,16778,2
4861,2020-08-13,종로구,301722.5909,237040,25318,1608,23710,0
4862,2020-08-13,중구,268023.9809,239488.3333,40015,2062,37953,1
4863,2020-08-13,중랑구,346771.4999,282266.25,16180,1286,14894,1
4864,2020-08-14,강남구,862448.437,631334.5833,55675,4353,51322,5
4865,2020-08-14,강동구,487210.7914,318427.5,20935,1897,19038,5
4866,2020-08-14,강북구,291910.5294,227067.9167,13461,1066,12395,0
4867,2020-08-14,강서구,532134.1667,431649.5833,26009,2632,23377,2
4868,2020-08-14,관악구,467946.3394,375590.8333,19710,1903,17807,2
4869,2020-08-14,광진구,358022.0625,275576.6667,18984,1668,17316,1
4870,2020-08-14,구로구,382599.2471,348605.8333,22249,1798,20451,0
4871,2020-08-14,금천구,225733.2517,227401.25,15627,1271,14356,0
4872,2020-08-14,노원구,505672.5679,378278.75,18235,1866,16369,4
4873,2020-08-14,도봉구,271306.9698,228921.25,11723,983,10740,1
4874,2020-08-14,동대문구,345586.6308,280562.0833,21157,1473,19684,3
4875,2020-08-14,동작구,384574.6515,301724.5833,15784,1570,14214,2
4876,2020-08-14,마포구,462584.8244,344620.4167,28401,2400,26001,6
4877,2020-08-14,서대문구,353972.4451,245014.1667,15007,1489,13518,3
4878,2020-08-14,서초구,595032.8312,428819.1667,36373,2535,33838,8
4879,2020-08-14,성동구,341810.7501,255413.3333,17062,1322,15740,1
4880,2020-08-14,성북구,407257.0174,320019.1667,17151,1584,15567,16
4881,2020-08-14,송파구,738181.1132,510978.75,37428,3169,34259,6
4882,2020-08-14,양천구,385823.4298,313392.5,18372,1663,16709,1
4883,2020-08-14,영등포구,470716.2943,402312.9167,27173,2259,24914,2
4884,2020-08-14,용산구,289551.485,216347.9167,18924,1183,17741,1
4885,2020-08-14,은평구,433168.2471,318805.4167,18350,1572,16778,1
4886,2020-08-14,종로구,289517.5341,227012.5,25318,1608,23710,0
4887,2020-08-14,중구,260582.8574,229467.9167,40015,2062,37953,1
4888,2020-08-14,중랑구,347028.4091,281850.4167,16180,1286,14894,1
4889,2020-08-14,중랑구,347028.4091,281850.4167,16180,1286,14894,1
4890,2020-08-15,강남구,715953.2472,491399.5833,55675,4353,51322,3
4891,2020-08-15,강동구,488832.7261,323947.0833,20935,1897,19038,2
4892,2020-08-15,강북구,301675.0787,237640.8333,13461,1066,12395,9
4893,2020-08-15,강서구,527031.0753,429100.4167,26009,2632,23377,6
4894,2020-08-15,관악구,477853.3015,389196.6667,19710,1903,17807,6
4895,2020-08-15,광진구,358894.7523,278849.1667,18984,1668,17316,7
4896,2020-08-15,구로구,369969.7005,334039.5833,22249,1798,20451,0
4897,2020-08-15,금천구,199381.807,195815.4167,15627,1271,14356,3
4898,2020-08-15,금천구,199381.807,195815.4167,15627,1271,14356,5
4899,2020-08-15,노원구,515308.0882,395290,18235,1866,16369,13
4900,2020-08-15,도봉구,279753.0953,240902.5,11723,983,10740,8
4901,2020-08-15,동대문구,337556.3229,274775,21157,1473,19684,7
4902,2020-08-15,동작구,383805.3045,302504.1667,15784,1570,14214,1
4903,2020-08-15,마포구,435462.1888,319733.75,28401,2400,26001,0
4904,2020-08-15,서대문구,336369.8764,238693.3333,15007,1489,13518,1
4905,2020-08-15,서초구,505458.172,349458.75,36373,2535,33838,2
4906,2020-08-15,성동구,317844.767,231195,17062,1322,15740,1
4907,2020-08-15,성북구,411157.2826,325978.75,17151,1584,15567,38
4908,2020-08-15,송파구,716507.7891,496647.5,37428,3169,34259,6
4909,2020-08-15,양천구,390439.2475,323592.0833,18372,1663,16709,2
4910,2020-08-15,영등포구,408835.2735,339285.8333,27173,2259,24914,2
4911,2020-08-15,용산구,271269.7063,199483.3333,18924,1183,17741,4
4912,2020-08-15,은평구,449862.6117,338357.9167,18350,1572,16778,5
4913,2020-08-15,종로구,255090.0273,182014.1667,25318,1608,23710,0
4914,2020-08-15,중구,196683.4499,150176.25,40015,2062,37953,0
4915,2020-08-15,중랑구,359570.796,294516.25,16180,1286,14894,8
4916,2020-08-15,중랑구,359570.796,294516.25,16180,1286,14894,7
4917,2020-08-16,강남구,668838.1999,454212.5,55675,4353,51322,1
4918,2020-08-16,강동구,488244.6906,322146.6667,20935,1897,19038,5
4919,2020-08-16,강북구,302812.3667,238711.6667,13461,1066,12395,2
4920,2020-08-16,강서구,520918.6481,423515.8333,26009,2632,23377,5
4921,2020-08-16,관악구,474577.6208,385937.9167,19710,1903,17807,0
4922,2020-08-16,광진구,354643.3778,274611.25,18984,1668,17316,3
4923,2020-08-16,구로구,364710.4266,329817.5,22249,1798,20451,0
4924,2020-08-16,금천구,195633.8337,192638.75,15627,1271,14356,2
4925,2020-08-16,노원구,513954.5679,393394.1667,18235,1866,16369,14
4926,2020-08-16,도봉구,282603.919,243670.4167,11723,983,10740,4
4927,2020-08-16,동대문구,335570.6181,271403.3333,21157,1473,19684,4
4928,2020-08-16,동작구,375207.3041,295206.6667,15784,1570,14214,1
4929,2020-08-16,마포구,423932.5272,309015.8333,28401,2400,26001,4
4930,2020-08-16,서대문구,331095.5484,235217.5,15007,1489,13518,0
4931,2020-08-16,서초구,480488.3403,328359.1667,36373,2535,33838,0
4932,2020-08-16,성동구,310016.4307,225165.4167,17062,1322,15740,1
4933,2020-08-16,성북구,410408.8231,324188.75,17151,1584,15567,19
4934,2020-08-16,송파구,700425.2186,483097.9167,37428,3169,34259,9
4935,2020-08-16,양천구,386073.7432,321047.5,18372,1663,16709,1
4936,2020-08-16,영등포구,398680.9455,329355,27173,2259,24914,0
4937,2020-08-16,용산구,264412.1072,192732.9167,18924,1183,17741,3
4938,2020-08-16,은평구,450037.7076,339618.75,18350,1572,16778,2
4939,2020-08-16,종로구,228900.24,160385,25318,1608,23710,2
4940,2020-08-16,중구,179921.1587,136359.5833,40015,2062,37953,1
4941,2020-08-16,중랑구,358718.3717,293965,16180,1286,14894,5
4942,2020-08-16,중랑구,358718.3717,293965,16180,1286,14894,3
4943,2020-08-17,강남구,712262.985,492205,55675,4353,51322,2
4944,2020-08-17,강동구,498754.5307,327647.9167,20935,1897,19038,5
4945,2020-08-17,강북구,302529.9365,236978.3333,13461,1066,12395,8
4946,2020-08-17,강서구,532050.58,433200.8333,26009,2632,23377,4
4947,2020-08-17,관악구,483584.0561,392806.6667,19710,1903,17807,2
4948,2020-08-17,광진구,361631.7718,281035,18984,1668,17316,4
4949,2020-08-17,구로구,369415.6611,338035,22249,1798,20451,2
4950,2020-08-17,금천구,206237.9375,204936.25,15627,1271,14356,1
4951,2020-08-17,노원구,520949.6967,396632.5,18235,1866,16369,12
4952,2020-08-17,도봉구,283293.8742,241988.75,11723,983,10740,3
4953,2020-08-17,동대문구,347580.2123,282938.3333,21157,1473,19684,6
4954,2020-08-17,동작구,386987.8168,305526.6667,15784,1570,14214,11
4955,2020-08-17,마포구,430228.2972,315157.0833,28401,2400,26001,3
4956,2020-08-17,서대문구,341088.8365,243535.4167,15007,1489,13518,1
4957,2020-08-17,서초구,508134.1802,350820,36373,2535,33838,1
4958,2020-08-17,성동구,325586.7768,239017.5,17062,1322,15740,0
4959,2020-08-17,성북구,417195.9788,331332.9167,17151,1584,15567,22
4960,2020-08-17,송파구,721929.5929,497815.4167,37428,3169,34259,10
4961,2020-08-17,양천구,395523.4117,326407.0833,18372,1663,16709,3
4962,2020-08-17,영등포구,411867.8314,343764.1667,27173,2259,24914,1
4963,2020-08-17,용산구,267096.1889,196039.5833,18924,1183,17741,0
4964,2020-08-17,은평구,453779.7348,339655.4167,18350,1572,16778,5
4965,2020-08-17,종로구,241238.9865,175795,25318,1608,23710,0
4966,2020-08-17,중구,200063.8055,156921.6667,40015,2062,37953,1
4967,2020-08-17,중랑구,362287.346,295896.6667,16180,1286,14894,9
4968,2020-08-17,중랑구,362287.346,295896.6667,16180,1286,14894,16
4969,2020-08-18,강남구,853579.0253,626213.75,55675,4353,51322,6
4970,2020-08-18,강동구,493364.8777,320247.9167,20935,1897,19038,8
4971,2020-08-18,강북구,292928.0263,227004.1667,13461,1066,12395,8
4972,2020-08-18,강서구,536001.1538,432413.75,26009,2632,23377,2
4973,2020-08-18,관악구,471397.1812,377073.75,19710,1903,17807,6
4974,2020-08-18,광진구,358566.1548,274375.8333,18984,1668,17316,3
4975,2020-08-18,구로구,386267.6404,352214.1667,22249,1798,20451,6
4976,2020-08-18,금천구,230433.5827,232818.3333,15627,1271,14356,1
4977,2020-08-18,금천구,230433.5827,232818.3333,15627,1271,14356,1
4978,2020-08-18,노원구,509486.0813,379287.0833,18235,1866,16369,9
4979,2020-08-18,도봉구,274585.9044,229941.25,11723,983,10740,4
4980,2020-08-18,동대문구,349267.9792,284431.25,21157,1473,19684,5
4981,2020-08-18,동작구,386408.9513,302904.5833,15784,1570,14214,4
4982,2020-08-18,마포구,456099.5117,339614.5833,28401,2400,26001,8
4983,2020-08-18,서대문구,355751.4507,245608.3333,15007,1489,13518,3
4984,2020-08-18,서초구,589132.7786,425102.5,36373,2535,33838,6
4985,2020-08-18,성동구,343739.6851,258056.6667,17062,1322,15740,2
4986,2020-08-18,성북구,412561.474,323677.9167,17151,1584,15567,20
4987,2020-08-18,송파구,739712.8955,511120.4167,37428,3169,34259,11
4988,2020-08-18,양천구,390761.5885,315238.3333,18372,1663,16709,4
4989,2020-08-18,영등포구,467811.3621,402551.25,27173,2259,24914,3
4990,2020-08-18,용산구,284247.7893,212628.75,18924,1183,17741,4
4991,2020-08-18,은평구,436411.9694,320565.4167,18350,1572,16778,5
4992,2020-08-18,종로구,289969.7093,229311.6667,25318,1608,23710,4
4993,2020-08-18,중구,277285.1578,242405.8333,40015,2062,37953,2
4994,2020-08-18,중랑구,350694.9585,283372.5,16180,1286,14894,9
4995,2020-08-18,중랑구,350694.9585,283372.5,16180,1286,14894,7
4996,2020-08-19,강남구,848320.6479,621010.4167,55675,4353,51322,5
4997,2020-08-19,강동구,501032.3661,321258.75,20935,1897,19038,15
4998,2020-08-19,강북구,293932.4844,227822.5,13461,1066,12395,9
4999,2020-08-19,강서구,537075.6959,433722.0833,26009,2632,23377,4
5000,2020-08-19,관악구,474871.2013,379667.5,19710,1903,17807,3
5001,2020-08-19,광진구,360335.6745,275535.8333,18984,1668,17316,2
5002,2020-08-19,구로구,388300.4917,353040.4167,22249,1798,20451,2
5003,2020-08-19,금천구,230283.1097,232572.0833,15627,1271,14356,0
5004,2020-08-19,노원구,511209.6722,381662.5,18235,1866,16369,9
5005,2020-08-19,도봉구,276099.1227,231416.25,11723,983,10740,2
5006,2020-08-19,동대문구,351443.144,285286.6667,21157,1473,19684,6
5007,2020-08-19,동작구,385851.6743,301829.1667,15784,1570,14214,4
5008,2020-08-19,마포구,455809.807,338896.6667,28401,2400,26001,2
5009,2020-08-19,서대문구,356541.4028,245765.8333,15007,1489,13518,4
5010,2020-08-19,서초구,586778.2553,422587.5,36373,2535,33838,3
5011,2020-08-19,성동구,346269.201,260094.1667,17062,1322,15740,0
5012,2020-08-19,성북구,415731.0845,326229.5833,17151,1584,15567,17
5013,2020-08-19,송파구,742628.6928,512068.3333,37428,3169,34259,14
5014,2020-08-19,양천구,392642.5485,317313.75,18372,1663,16709,2
5015,2020-08-19,영등포구,469918.1855,402372.5,27173,2259,24914,2
5016,2020-08-19,용산구,283285.7083,212115.8333,18924,1183,17741,0
5017,2020-08-19,은평구,439856.7589,322293.3333,18350,1572,16778,11
5018,2020-08-19,종로구,286749.0915,225940.4167,25318,1608,23710,4
5019,2020-08-19,중구,274101.2872,236872.9167,40015,2062,37953,0
5020,2020-08-19,중랑구,352326.0145,284195,16180,1286,14894,4
5021,2020-08-19,중랑구,352326.0145,284195,16180,1286,14894,11
5022,2020-08-20,강남구,841550.0433,615467.9167,55675,4353,51322,5
5023,2020-08-20,강동구,497423.9605,321875.4167,20935,1897,19038,2
5024,2020-08-20,강북구,293943.0911,227556.25,13461,1066,12395,2
5025,2020-08-20,강서구,538239.5345,433443.75,26009,2632,23377,14
5026,2020-08-20,관악구,476116.0445,379697.5,19710,1903,17807,3
5027,2020-08-20,광진구,360264.7583,275709.1667,18984,1668,17316,3
5028,2020-08-20,구로구,388725.49,352731.25,22249,1798,20451,5
5029,2020-08-20,금천구,229662.8361,231894.1667,15627,1271,14356,2
5030,2020-08-20,노원구,512610.2763,381219.5833,18235,1866,16369,6
5031,2020-08-20,도봉구,276830.6183,232251.6667,11723,983,10740,6
5032,2020-08-20,동대문구,351866.2291,285066.25,21157,1473,19684,7
5033,2020-08-20,동작구,385854.801,301631.25,15784,1570,14214,2
5034,2020-08-20,마포구,455194.9968,337805.4167,28401,2400,26001,2
5035,2020-08-20,서대문구,356913.0683,246116.6667,15007,1489,13518,0
5036,2020-08-20,서초구,583395.8571,418837.0833,36373,2535,33838,6
5037,2020-08-20,성동구,345668.531,259845,17062,1322,15740,4
5038,2020-08-20,성북구,415610.1117,326037.0833,17151,1584,15567,10
5039,2020-08-20,송파구,743378.3686,512379.1667,37428,3169,34259,12
5040,2020-08-20,양천구,393175.5647,317833.3333,18372,1663,16709,2
5041,2020-08-20,영등포구,469991.1419,401887.9167,27173,2259,24914,1
5042,2020-08-20,용산구,283309.2869,211502.9167,18924,1183,17741,2
5043,2020-08-20,은평구,441438.3347,323287.0833,18350,1572,16778,10
5044,2020-08-20,종로구,282716.9601,222404.1667,25318,1608,23710,3
5045,2020-08-20,중구,272845.905,234031.25,40015,2062,37953,4
5046,2020-08-20,중랑구,352694.9944,284470.4167,16180,1286,14894,7
5047,2020-08-20,중랑구,352694.9944,284470.4167,16180,1286,14894,6
5048,2020-08-21,강남구,830595.0136,606997.9167,55675,4353,51322,5
5049,2020-08-21,강동구,497419.3691,320851.25,20935,1897,19038,5
5050,2020-08-21,강북구,294802.7799,228183.75,13461,1066,12395,6
5051,2020-08-21,강서구,538602.2806,433281.6667,26009,2632,23377,7
5052,2020-08-21,관악구,477697.9331,379770.8333,19710,1903,17807,4
5053,2020-08-21,광진구,361143.407,276187.5,18984,1668,17316,7
5054,2020-08-21,구로구,387257.1379,351596.6667,22249,1798,20451,8
5055,2020-08-21,금천구,228177.1693,229761.6667,15627,1271,14356,2
5056,2020-08-21,금천구,228177.1693,229761.6667,15627,1271,14356,1
5057,2020-08-21,노원구,513168.4136,382468.3333,18235,1866,16369,3
5058,2020-08-21,도봉구,277299.0771,232732.0833,11723,983,10740,1
5059,2020-08-21,동대문구,351516.3953,284072.5,21157,1473,19684,6
5060,2020-08-21,동작구,385368.6914,301042.9167,15784,1570,14214,4
5061,2020-08-21,마포구,453864.7826,336637.0833,28401,2400,26001,8
5062,2020-08-21,서대문구,354476.2422,244780.8333,15007,1489,13518,6
5063,2020-08-21,서초구,581115.8015,416559.5833,36373,2535,33838,4
5064,2020-08-21,성동구,344496.6281,258207.9167,17062,1322,15740,3
5065,2020-08-21,성북구,415632.6722,326334.5833,17151,1584,15567,7
5066,2020-08-21,송파구,741599.7072,511247.5,37428,3169,34259,12
5067,2020-08-21,양천구,386964.4408,318374.1667,18372,1663,16709,7
5068,2020-08-21,영등포구,467512.8884,398613.75,27173,2259,24914,1
5069,2020-08-21,용산구,283010.7502,211201.25,18924,1183,17741,2
5070,2020-08-21,은평구,441815.7225,323960.4167,18350,1572,16778,8
5071,2020-08-21,종로구,276212.3196,216007.9167,25318,1608,23710,2
5072,2020-08-21,중구,270068.6475,227702.0833,40015,2062,37953,2
5073,2020-08-21,중랑구,353554.9064,284703.75,16180,1286,14894,2
5074,2020-08-21,중랑구,353554.9064,284703.75,16180,1286,14894,5
5075,2020-08-22,강남구,709071.8313,487366.25,55675,4353,51322,7
5076,2020-08-22,강동구,510107.8236,333291.6667,20935,1897,19038,12
5077,2020-08-22,강북구,306722.9859,240138.75,13461,1066,12395,4
5078,2020-08-22,강서구,541876.796,438339.5833,26009,2632,23377,5
5079,2020-08-22,관악구,497069.2505,401205,19710,1903,17807,5
5080,2020-08-22,광진구,364852.5888,282803.75,18984,1668,17316,2
5081,2020-08-22,구로구,375966.2396,341493.3333,22249,1798,20451,2
5082,2020-08-22,금천구,204464.7992,201090.8333,15627,1271,14356,1
5083,2020-08-22,노원구,531810.425,405846.25,18235,1866,16369,15
5084,2020-08-22,도봉구,288357.5771,247744.1667,11723,983,10740,3
5085,2020-08-22,동대문구,347735.2177,282713.3333,21157,1473,19684,3
5086,2020-08-22,동작구,393423.7467,308572.0833,15784,1570,14214,9
5087,2020-08-22,마포구,432412.8819,315928.3333,28401,2400,26001,4
5088,2020-08-22,서대문구,341763.3033,243303.75,15007,1489,13518,1
5089,2020-08-22,서초구,509943.0407,349218.3333,36373,2535,33838,7
5090,2020-08-22,성동구,324082.2562,237617.5,17062,1322,15740,1
5091,2020-08-22,성북구,424736.3455,337086.25,17151,1584,15567,14
5092,2020-08-22,송파구,728128.2915,499035,37428,3169,34259,5
5093,2020-08-22,양천구,396080.605,334654.5833,18372,1663,16709,5
5094,2020-08-22,영등포구,413574.2918,343600,27173,2259,24914,6
5095,2020-08-22,용산구,264679.2473,194045.4167,18924,1183,17741,4
5096,2020-08-22,은평구,463539.839,348556.6667,18350,1572,16778,11
5097,2020-08-22,종로구,225849.9656,159273.3333,25318,1608,23710,1
5098,2020-08-22,중구,194711.4897,142638.75,40015,2062,37953,1
5099,2020-08-22,중랑구,368474.632,300758.3333,16180,1286,14894,5
5100,2020-08-22,중랑구,368474.632,300758.3333,16180,1286,14894,10
5101,2020-08-23,강남구,666269.6032,451649.1667,55675,4353,51322,5
5102,2020-08-23,강동구,513637.7184,334967.5,20935,1897,19038,4
5103,2020-08-23,강북구,312028.8421,245624.1667,13461,1066,12395,2
5104,2020-08-23,강서구,544762.9033,439760,26009,2632,23377,6
5105,2020-08-23,관악구,504547.0439,407660,19710,1903,17807,3
5106,2020-08-23,광진구,365947.4327,284272.5,18984,1668,17316,1
5107,2020-08-23,구로구,377689.6999,343914.1667,22249,1798,20451,4
5108,2020-08-23,금천구,203554.1335,200261.25,15627,1271,14356,3
5109,2020-08-23,노원구,537783.8116,410794.1667,18235,1866,16369,3
5110,2020-08-23,도봉구,294136.0859,254532.9167,11723,983,10740,0
5111,2020-08-23,동대문구,346394.9089,280859.5833,21157,1473,19684,4
5112,2020-08-23,동작구,396490.582,309600.4167,15784,1570,14214,1
5113,2020-08-23,마포구,425120.9354,309192.5,28401,2400,26001,3
5114,2020-08-23,서대문구,340398.5376,243115.8333,15007,1489,13518,2
5115,2020-08-23,서초구,487460.5469,330834.1667,36373,2535,33838,1
5116,2020-08-23,성동구,320067.7728,232698.75,17062,1322,15740,2
5117,2020-08-23,성북구,429131.7366,340311.6667,17151,1584,15567,8
5118,2020-08-23,송파구,722459.3325,495425.8333,37428,3169,34259,5
5119,2020-08-23,양천구,397058.3067,338445.8333,18372,1663,16709,10
5120,2020-08-23,영등포구,406257.7858,336683.3333,27173,2259,24914,3
5121,2020-08-23,용산구,259536.5971,188932.0833,18924,1183,17741,5
5122,2020-08-23,은평구,471389.5779,355377.9167,18350,1572,16778,6
5123,2020-08-23,종로구,215008.926,148311.6667,25318,1608,23710,2
5124,2020-08-23,중구,175373.1344,125376.25,40015,2062,37953,3
5125,2020-08-23,중랑구,372635.3251,305497.9167,16180,1286,14894,8
5126,2020-08-23,중랑구,372635.3251,305497.9167,16180,1286,14894,4
5127,2020-08-24,강남구,821422.8982,601454.5833,55675,4353,51322,5
5128,2020-08-24,강동구,501120.1555,322770.4167,20935,1897,19038,7
5129,2020-08-24,강북구,296909.7397,229019.5833,13461,1066,12395,2
5130,2020-08-24,강서구,542748.1052,436123.3333,26009,2632,23377,3
5131,2020-08-24,관악구,481395.8832,381030.8333,19710,1903,17807,8
5132,2020-08-24,광진구,360869.4667,275572.9167,18984,1668,17316,6
5133,2020-08-24,구로구,388581.433,353510.8333,22249,1798,20451,2
5134,2020-08-24,금천구,232558.0956,235401.6667,15627,1271,14356,2
5135,2020-08-24,노원구,515354.7184,382094.5833,18235,1866,16369,14
5136,2020-08-24,도봉구,280122.6716,234951.6667,11723,983,10740,6
5137,2020-08-24,동대문구,353131.2999,285606.25,21157,1473,19684,3
5138,2020-08-24,동작구,387543.4564,301820.4167,15784,1570,14214,1
5139,2020-08-24,마포구,450513.4823,334831.25,28401,2400,26001,1
5140,2020-08-24,서대문구,354795.8433,244483.75,15007,1489,13518,4
5141,2020-08-24,서초구,578222.1364,414792.5,36373,2535,33838,5
5142,2020-08-24,성동구,345871.8683,259577.5,17062,1322,15740,2
5143,2020-08-24,성북구,417342.8316,327903.75,17151,1584,15567,11
5144,2020-08-24,송파구,741722.0121,510020.8333,37428,3169,34259,7
5145,2020-08-24,양천구,385818.8607,318775.4167,18372,1663,16709,6
5146,2020-08-24,영등포구,467157.9584,400902.5,27173,2259,24914,4
5147,2020-08-24,용산구,281206.6914,208517.9167,18924,1183,17741,3
5148,2020-08-24,은평구,446010.6653,326125,18350,1572,16778,6
5149,2020-08-24,종로구,274681.1045,215392.5,25318,1608,23710,1
5150,2020-08-24,중구,271295.3859,230226.25,40015,2062,37953,0
5151,2020-08-24,중랑구,356025.3888,286964.5833,16180,1286,14894,13
5152,2020-08-24,중랑구,356025.3888,286964.5833,16180,1286,14894,14
5153,2020-08-25,강남구,832325.957,608132.9167,55675,4353,51322,6
5154,2020-08-25,강동구,500953.0667,322869.5833,20935,1897,19038,8
5155,2020-08-25,강북구,296445.5956,228553.3333,13461,1066,12395,4
5156,2020-08-25,강서구,543178.5704,437786.6667,26009,2632,23377,10
5157,2020-08-25,관악구,481068.945,381756.25,19710,1903,17807,9
5158,2020-08-25,광진구,360819.5264,275257.9167,18984,1668,17316,4
5159,2020-08-25,구로구,388212.4614,351236.25,22249,1798,20451,2
5160,2020-08-25,금천구,231962.6827,234175.8333,15627,1271,14356,2
5161,2020-08-25,노원구,515135.3892,382570.8333,18235,1866,16369,4
5162,2020-08-25,도봉구,279224.311,233822.9167,11723,983,10740,1
5163,2020-08-25,동대문구,354162.4776,286283.75,21157,1473,19684,3
5164,2020-08-25,동작구,387723.7055,302015.8333,15784,1570,14214,3
5165,2020-08-25,마포구,452974.2307,336551.6667,28401,2400,26001,7
5166,2020-08-25,서대문구,356528.6255,245872.5,15007,1489,13518,1
5167,2020-08-25,서초구,584941.9395,418952.9167,36373,2535,33838,5
5168,2020-08-25,성동구,347796.2595,260936.25,17062,1322,15740,1
5169,2020-08-25,성북구,417962.006,328410.8333,17151,1584,15567,3
5170,2020-08-25,송파구,743249.6865,511346.25,37428,3169,34259,6
5171,2020-08-25,양천구,385738.2888,316506.25,18372,1663,16709,5
5172,2020-08-25,영등포구,469161.9069,401171.25,27173,2259,24914,9
5173,2020-08-25,용산구,280965.2006,208624.5833,18924,1183,17741,2
5174,2020-08-25,은평구,444377.703,325528.75,18350,1572,16778,6
5175,2020-08-25,종로구,279087.0238,214974.5833,25318,1608,23710,4
5176,2020-08-25,중구,274565.1918,230733.3333,40015,2062,37953,1
5177,2020-08-25,중랑구,355019.0248,286445.8333,16180,1286,14894,5
5178,2020-08-25,중랑구,355019.0248,286445.8333,16180,1286,14894,5
5179,2020-08-26,강남구,830090.3261,603836.25,55675,4353,51322,3
5180,2020-08-26,강동구,505736.0769,325384.1667,20935,1897,19038,2
5181,2020-08-26,강북구,299156.3717,230265,13461,1066,12395,2
5182,2020-08-26,강서구,542696.5339,438272.9167,26009,2632,23377,12
5183,2020-08-26,관악구,484714.7073,384477.0833,19710,1903,17807,6
5184,2020-08-26,광진구,363214.7501,277294.1667,18984,1668,17316,4
5185,2020-08-26,구로구,390285.8864,351202.5,22249,1798,20451,9
5186,2020-08-26,금천구,232142.4361,234921.6667,15627,1271,14356,10
5187,2020-08-26,노원구,518150.3041,385598.75,18235,1866,16369,24
5188,2020-08-26,도봉구,280213.5133,235148.3333,11723,983,10740,1
5189,2020-08-26,동대문구,355355.5488,287728.3333,21157,1473,19684,1
5190,2020-08-26,동작구,389752.2543,306833.75,15784,1570,14214,7
5191,2020-08-26,마포구,454130.0524,335935.8333,28401,2400,26001,4
5192,2020-08-26,서대문구,356778.3381,246690.4167,15007,1489,13518,9
5193,2020-08-26,서초구,583333.8142,416857.0833,36373,2535,33838,2
5194,2020-08-26,성동구,348290.6533,261452.5,17062,1322,15740,4
5195,2020-08-26,성북구,421583.4016,330813.75,17151,1584,15567,11
5196,2020-08-26,송파구,746263.4378,513440.8333,37428,3169,34259,9
5197,2020-08-26,양천구,388837.2763,318067.9167,18372,1663,16709,5
5198,2020-08-26,영등포구,468297.6485,400880,27173,2259,24914,5
5199,2020-08-26,용산구,283417.3824,210415.4167,18924,1183,17741,3
5200,2020-08-26,은평구,447872.782,328166.6667,18350,1572,16778,7
5201,2020-08-26,종로구,277381.2586,214337.5,25318,1608,23710,2
5202,2020-08-26,중구,271551.3949,228012.0833,40015,2062,37953,1
5203,2020-08-26,중랑구,357099.5934,288541.25,16180,1286,14894,4
5204,2020-08-26,중랑구,357099.5934,288541.25,16180,1286,14894,10
5205,2020-08-27,강남구,821984.9338,596480,55675,4353,51322,4
5206,2020-08-27,강동구,507111.0922,326577.5,20935,1897,19038,7
5207,2020-08-27,강북구,302160.5483,233017.5,13461,1066,12395,7
5208,2020-08-27,강서구,546729.7067,441662.9167,26009,2632,23377,4
5209,2020-08-27,관악구,487244.8033,386485.8333,19710,1903,17807,14
5210,2020-08-27,광진구,364304.191,277813.75,18984,1668,17316,4
5211,2020-08-27,구로구,393285.431,354030,22249,1798,20451,7
5212,2020-08-27,금천구,232769.7116,235798.3333,15627,1271,14356,1
5213,2020-08-27,금천구,232769.7116,235798.3333,15627,1271,14356,1
5214,2020-08-27,노원구,521358.7814,388025.8333,18235,1866,16369,16
5215,2020-08-27,도봉구,281410.0475,237554.1667,11723,983,10740,5
5216,2020-08-27,동대문구,355590.4557,288390.8333,21157,1473,19684,2
5217,2020-08-27,동작구,390644.9658,306677.5,15784,1570,14214,8
5218,2020-08-27,마포구,452765.2781,335230.4167,28401,2400,26001,12
5219,2020-08-27,서대문구,357026.0202,245781.25,15007,1489,13518,2
5220,2020-08-27,서초구,577077.1087,410670.4167,36373,2535,33838,3
5221,2020-08-27,성동구,348370.9568,260779.5833,17062,1322,15740,0
5222,2020-08-27,성북구,424312.4848,332344.1667,17151,1584,15567,7
5223,2020-08-27,송파구,748153.483,515309.1667,37428,3169,34259,16
5224,2020-08-27,양천구,390262.8947,322220.4167,18372,1663,16709,3
5225,2020-08-27,영등포구,464983.6265,397199.1667,27173,2259,24914,7
5226,2020-08-27,용산구,281181.5918,208246.25,18924,1183,17741,4
5227,2020-08-27,은평구,450603.1477,331375,18350,1572,16778,9
5228,2020-08-27,종로구,273003.1409,210547.5,25318,1608,23710,3
5229,2020-08-27,중구,267067.9193,223493.3333,40015,2062,37953,2
5230,2020-08-27,중랑구,359894.661,291506.6667,16180,1286,14894,4
5231,2020-08-27,중랑구,359894.661,291506.6667,16180,1286,14894,8
5232,2020-08-28,강남구,821815.8218,600293.3333,55675,4353,51322,4
5233,2020-08-28,강동구,501176.1361,324507.9167,20935,1897,19038,2
5234,2020-08-28,강북구,297947.8929,230399.5833,13461,1066,12395,4
5235,2020-08-28,강서구,540045.9869,437456.6667,26009,2632,23377,4
5236,2020-08-28,관악구,480948.8011,383767.9167,19710,1903,17807,10
5237,2020-08-28,광진구,362155.9465,277823.75,18984,1668,17316,5
5238,2020-08-28,구로구,387914.4223,351002.0833,22249,1798,20451,2
5239,2020-08-28,금천구,229534.871,233058.75,15627,1271,14356,3
5240,2020-08-28,노원구,515502.9969,384988.3333,18235,1866,16369,7
5241,2020-08-28,도봉구,278253.4009,235050,11723,983,10740,6
5242,2020-08-28,동대문구,352675.015,286679.5833,21157,1473,19684,2
5243,2020-08-28,동작구,386982.8009,305173.3333,15784,1570,14214,12
5244,2020-08-28,마포구,453538.2399,337112.5,28401,2400,26001,2
5245,2020-08-28,서대문구,352908.6375,245342.9167,15007,1489,13518,5
5246,2020-08-28,서초구,578062.6453,415588.3333,36373,2535,33838,6
5247,2020-08-28,성동구,345738.0255,260336.25,17062,1322,15740,0
5248,2020-08-28,성북구,418820.4445,329327.9167,17151,1584,15567,6
5249,2020-08-28,송파구,741972.7336,512594.5833,37428,3169,34259,14
5250,2020-08-28,양천구,386212.4485,320798.75,18372,1663,16709,3
5251,2020-08-28,영등포구,461301.3829,396410,27173,2259,24914,5
5252,2020-08-28,용산구,281396.2556,210088.3333,18924,1183,17741,1
5253,2020-08-28,은평구,445671.1195,328583.75,18350,1572,16778,1
5254,2020-08-28,종로구,271108.0118,209300.4167,25318,1608,23710,0
5255,2020-08-28,중구,267079.9713,224209.1667,40015,2062,37953,3
5256,2020-08-28,중랑구,355770.5425,288503.75,16180,1286,14894,4
5257,2020-08-28,중랑구,355770.5425,288503.75,16180,1286,14894,7
5258,2020-08-29,강남구,702091.2325,482649.5833,55675,4353,51322,4
5259,2020-08-29,강동구,514350.0572,335155.4167,20935,1897,19038,1
5260,2020-08-29,강북구,310208.8355,241991.25,13461,1066,12395,3
5261,2020-08-29,강서구,544159.3271,443162.9167,26009,2632,23377,6
5262,2020-08-29,관악구,501974.1148,405019.1667,19710,1903,17807,8
5263,2020-08-29,광진구,367215.2359,284409.1667,18984,1668,17316,6
5264,2020-08-29,구로구,379273.8068,341509.1667,22249,1798,20451,6
5265,2020-08-29,금천구,206559.1251,203628.3333,15627,1271,14356,2
5266,2020-08-29,금천구,206559.1251,203628.3333,15627,1271,14356,5
5267,2020-08-29,노원구,535782.8831,408320.8333,18235,1866,16369,18
5268,2020-08-29,도봉구,290306.4244,250235.4167,11723,983,10740,2
5269,2020-08-29,동대문구,350389.6782,285030.4167,21157,1473,19684,6
5270,2020-08-29,동작구,396225.9506,312092.0833,15784,1570,14214,16
5271,2020-08-29,마포구,432746.0525,316472.5,28401,2400,26001,3
5272,2020-08-29,서대문구,342483.4284,243322.0833,15007,1489,13518,5
5273,2020-08-29,서초구,508759.3501,348107.5,36373,2535,33838,3
5274,2020-08-29,성동구,326797.2331,239498.3333,17062,1322,15740,2
5275,2020-08-29,성북구,429992.3626,340311.6667,17151,1584,15567,7
5276,2020-08-29,송파구,730762.3784,501302.0833,37428,3169,34259,12
5277,2020-08-29,양천구,397595.0576,333319.5833,18372,1663,16709,8
5278,2020-08-29,영등포구,413768.278,345921.6667,27173,2259,24914,13
5279,2020-08-29,용산구,263742.3814,193230.4167,18924,1183,17741,0
5280,2020-08-29,은평구,469462.2391,351671.25,18350,1572,16778,9
5281,2020-08-29,종로구,223766.2986,156537.0833,25318,1608,23710,4
5282,2020-08-29,중구,192092.1062,140365,40015,2062,37953,2
5283,2020-08-29,중랑구,371465.9872,304081.6667,16180,1286,14894,7
5284,2020-08-29,중랑구,371465.9872,304081.6667,16180,1286,14894,9
5285,2020-08-30,강남구,658244.0578,444992.5,55675,4353,51322,3
5286,2020-08-30,강동구,519189.121,338506.25,20935,1897,19038,2
5287,2020-08-30,강북구,315429.8729,246980.4167,13461,1066,12395,4
5288,2020-08-30,강서구,549082.3693,444548.75,26009,2632,23377,4
5289,2020-08-30,관악구,510899.8749,412182.0833,19710,1903,17807,5
5290,2020-08-30,광진구,368763.8764,286120.8333,18984,1668,17316,2
5291,2020-08-30,구로구,382945.1276,345280.8333,22249,1798,20451,1
5292,2020-08-30,금천구,206394.8048,203488.75,15627,1271,14356,2
5293,2020-08-30,금천구,206394.8048,203488.75,15627,1271,14356,1
5294,2020-08-30,노원구,544231.9024,414930.4167,18235,1866,16369,7
5295,2020-08-30,도봉구,296484.7536,257212.9167,11723,983,10740,7
5296,2020-08-30,동대문구,348950.8454,283845,21157,1473,19684,2
5297,2020-08-30,동작구,399357.68,314118.75,15784,1570,14214,13
5298,2020-08-30,마포구,425026.2197,308445.8333,28401,2400,26001,1
5299,2020-08-30,서대문구,342443.5934,243885.4167,15007,1489,13518,1
5300,2020-08-30,서초구,486028.4607,328942.9167,36373,2535,33838,0
5301,2020-08-30,성동구,323100.9818,235445.4167,17062,1322,15740,1
5302,2020-08-30,성북구,437246.2973,345810.4167,17151,1584,15567,4
5303,2020-08-30,송파구,726006.1147,498377.9167,37428,3169,34259,1
5304,2020-08-30,양천구,400557.7542,337778.75,18372,1663,16709,1
5305,2020-08-30,영등포구,407552.1068,339699.1667,27173,2259,24914,0
5306,2020-08-30,용산구,259666.0342,188742.9167,18924,1183,17741,0
5307,2020-08-30,은평구,478660.8396,359486.6667,18350,1572,16778,3
5308,2020-08-30,종로구,211571.6796,144619.1667,25318,1608,23710,0
5309,2020-08-30,중구,173955.6694,123063.3333,40015,2062,37953,1
5310,2020-08-30,중랑구,378286.7083,310490.4167,16180,1286,14894,2
5311,2020-08-30,중랑구,378286.7083,310490.4167,16180,1286,14894,2
5312,2020-08-31,강남구,800881.8953,598747.0833,55675,4353,51322,12
5313,2020-08-31,강동구,504370.5738,328907.9167,20935,1897,19038,2
5314,2020-08-31,강북구,300320.6909,233219.1667,13461,1066,12395,7
5315,2020-08-31,강서구,544870.8488,441092.9167,26009,2632,23377,7
5316,2020-08-31,관악구,485464.6239,389978.75,19710,1903,17807,10
5317,2020-08-31,광진구,363456.5699,281528.3333,18984,1668,17316,0
5318,2020-08-31,구로구,391482.4731,356740.8333,22249,1798,20451,0
5319,2020-08-31,금천구,233033.6173,239390.4167,15627,1271,14356,1
5320,2020-08-31,금천구,233033.6173,239390.4167,15627,1271,14356,1
5321,2020-08-31,노원구,519196.1713,390677.9167,18235,1866,16369,11
5322,2020-08-31,도봉구,280716.3352,239375.8333,11723,983,10740,5
5323,2020-08-31,동대문구,355506.0221,293528.75,21157,1473,19684,1
5324,2020-08-31,동작구,387608.8442,308561.6667,15784,1570,14214,4
5325,2020-08-31,마포구,447989.2144,337852.9167,28401,2400,26001,3
5326,2020-08-31,서대문구,355687.8243,248759.5833,15007,1489,13518,1
5327,2020-08-31,서초구,573137.5173,417081.6667,36373,2535,33838,5
5328,2020-08-31,성동구,346672.03,264257.5,17062,1322,15740,2
5329,2020-08-31,성북구,425023.6553,338862.0833,17151,1584,15567,6
5330,2020-08-31,송파구,742677.8378,518447.0833,37428,3169,34259,3
5331,2020-08-31,양천구,384102.9125,323929.1667,18372,1663,16709,6
5332,2020-08-31,영등포구,466140.7866,405673.3333,27173,2259,24914,0
5333,2020-08-31,용산구,282195.6913,212702.9167,18924,1183,17741,2
5334,2020-08-31,은평구,449585.9084,332800.4167,18350,1572,16778,3
5335,2020-08-31,종로구,272909.3277,214046.6667,25318,1608,23710,2
5336,2020-08-31,중구,267535.5238,230347.5,40015,2062,37953,0
5337,2020-08-31,중랑구,359603.2996,293332.0833,16180,1286,14894,6
5338,2020-08-31,중랑구,359603.2996,293332.0833,16180,1286,14894,4
